variable	variable2	values	mappedTerms	valueOrder
ext_crypt_ari_lab::doc	ext_crypt_ari_lab::doc	NA	NA	
ext_crypt_ari_lab::influ_pcr	ext_crypt_ari_lab::influ_pcr	NA	NA	
ext_crypt_ari_lab::rv_pcr	ext_crypt_ari_lab::rv_pcr	NA	NA	
ext_crypt_ari::dov	ext_crypt_ari::dov	NA	NA	
ext_crypt_ari::pq26	ext_crypt_ari::pq26	NA	NA	
ext_crypt_ari::pq27	ext_crypt_ari::pq27	NA	NA	
ext_crypt_ari::pq28	ext_crypt_ari::pq28	NA	NA	
ext_crypt_ari::pq29	ext_crypt_ari::pq29	NA	NA	
ext_crypt_bayleysc::age	ext_crypt_bayleysc::age	NA	NA	
ext_crypt_bayleysc::cogcmp	ext_crypt_bayleysc::cogcmp	NA	NA	
ext_crypt_bayleysc::cograw	ext_crypt_bayleysc::cograw	NA	NA	
ext_crypt_bayleysc::cogscale	ext_crypt_bayleysc::cogscale	NA	NA	
ext_crypt_bayleysc::date	ext_crypt_bayleysc::date	NA	NA	
ext_crypt_bayleysc::fmotoraw	ext_crypt_bayleysc::fmotoraw	NA	NA	
ext_crypt_bayleysc::fmotoscal	ext_crypt_bayleysc::fmotoscal	NA	NA	
ext_crypt_bayleysc::gmotoraw	ext_crypt_bayleysc::gmotoraw	NA	NA	
ext_crypt_bayleysc::gmotoscal	ext_crypt_bayleysc::gmotoscal	NA	NA	
ext_crypt_bayleysc::laexpraw	ext_crypt_bayleysc::laexpraw	NA	NA	
ext_crypt_bayleysc::laexpscal	ext_crypt_bayleysc::laexpscal	NA	NA	
ext_crypt_bayleysc::langcmp	ext_crypt_bayleysc::langcmp	NA	NA	
ext_crypt_bayleysc::langscal	ext_crypt_bayleysc::langscal	NA	NA	
ext_crypt_bayleysc::larcraw	ext_crypt_bayleysc::larcraw	NA	NA	
ext_crypt_bayleysc::larcscal	ext_crypt_bayleysc::larcscal	NA	NA	
ext_crypt_bayleysc::motocmp	ext_crypt_bayleysc::motocmp	NA	NA	
ext_crypt_bayleysc::motoscal	ext_crypt_bayleysc::motoscal	NA	NA	
ext_crypt_bayleysc::vnum	ext_crypt_bayleysc::vnum	NA	NA	
ext_crypt_cs_bml::aa	ext_crypt_cs_bml::aa	NA	NA	
ext_crypt_cs_bml::ala	ext_crypt_cs_bml::ala	NA	NA	
ext_crypt_cs_bml::ara	ext_crypt_cs_bml::ara	NA	NA	
ext_crypt_cs_bml::beh	ext_crypt_cs_bml::beh	NA	NA	
ext_crypt_cs_bml::cap	ext_crypt_cs_bml::cap	NA	NA	
ext_crypt_cs_bml::dgla	ext_crypt_cs_bml::dgla	NA	NA	
ext_crypt_cs_bml::dha	ext_crypt_cs_bml::dha	NA	NA	
ext_crypt_cs_bml::doc	ext_crypt_cs_bml::doc	NA	NA	
ext_crypt_cs_bml::dpa	ext_crypt_cs_bml::dpa	NA	NA	
ext_crypt_cs_bml::dpa6	ext_crypt_cs_bml::dpa6	NA	NA	
ext_crypt_cs_bml::dta	ext_crypt_cs_bml::dta	NA	NA	
ext_crypt_cs_bml::eda	ext_crypt_cs_bml::eda	NA	NA	
ext_crypt_cs_bml::eic9	ext_crypt_cs_bml::eic9	NA	NA	
ext_crypt_cs_bml::ela	ext_crypt_cs_bml::ela	NA	NA	
ext_crypt_cs_bml::epa	ext_crypt_cs_bml::epa	NA	NA	
ext_crypt_cs_bml::gla	ext_crypt_cs_bml::gla	NA	NA	
ext_crypt_cs_bml::la	ext_crypt_cs_bml::la	NA	NA	
ext_crypt_cs_bml::lau	ext_crypt_cs_bml::lau	NA	NA	
ext_crypt_cs_bml::lig	ext_crypt_cs_bml::lig	NA	NA	
ext_crypt_cs_bml::lla	ext_crypt_cs_bml::lla	NA	NA	
ext_crypt_cs_bml::myr	ext_crypt_cs_bml::myr	NA	NA	
ext_crypt_cs_bml::ner	ext_crypt_cs_bml::ner	NA	NA	
ext_crypt_cs_bml::ole	ext_crypt_cs_bml::ole	NA	NA	
ext_crypt_cs_bml::pal	ext_crypt_cs_bml::pal	NA	NA	
ext_crypt_cs_bml::pla	ext_crypt_cs_bml::pla	NA	NA	
ext_crypt_cs_bml::ple	ext_crypt_cs_bml::ple	NA	NA	
ext_crypt_cs_bml::ste	ext_crypt_cs_bml::ste	NA	NA	
ext_crypt_cs_calp::aged	ext_crypt_cs_calp::aged	NA	NA	
ext_crypt_cs_calp::specdt	ext_crypt_cs_calp::specdt	NA	NA	
ext_crypt_cs_calp::specseq	ext_crypt_cs_calp::specseq	NA	NA	
ext_crypt_cs_cp17_fecal_iga::aged	ext_crypt_cs_cp17_fecal_iga::aged	NA	NA	
ext_crypt_cs_cp17_fecal_iga::specdt	ext_crypt_cs_cp17_fecal_iga::specdt	NA	NA	
ext_crypt_cs_cp17_fecal_iga::specnum	ext_crypt_cs_cp17_fecal_iga::specnum	NA	NA	
ext_crypt_cs_cp17_fecal_iga::specseq	ext_crypt_cs_cp17_fecal_iga::specseq	NA	NA	
ext_crypt_cs_cp17_plasma_igg::aged	ext_crypt_cs_cp17_plasma_igg::aged	NA	NA	
ext_crypt_cs_cp17_plasma_igg::specdt	ext_crypt_cs_cp17_plasma_igg::specdt	NA	NA	
ext_crypt_cs_cp23_fecal_iga::aged	ext_crypt_cs_cp23_fecal_iga::aged	NA	NA	
ext_crypt_cs_cp23_fecal_iga::specdt	ext_crypt_cs_cp23_fecal_iga::specdt	NA	NA	
ext_crypt_cs_cp23_plasma_igg::aged	ext_crypt_cs_cp23_plasma_igg::aged	NA	NA	
ext_crypt_cs_cp23_plasma_igg::specdt	ext_crypt_cs_cp23_plasma_igg::specdt	NA	NA	
ext_crypt_cs_crem_prkca::crem_rs2148483_a	ext_crypt_cs_crem_prkca::crem_rs2148483_a	NA	NA	
ext_crypt_cs_crem_prkca::prkca_rs58296998_t	ext_crypt_cs_crem_prkca::prkca_rs58296998_t	NA	NA	
ext_crypt_cs_crp::specdt	ext_crypt_cs_crp::specdt	NA	NA	
ext_crypt_cs_cytcp::aged	ext_crypt_cs_cytcp::aged	NA	NA	
ext_crypt_cs_cytcp::gcsf	ext_crypt_cs_cytcp::gcsf	NA	NA	
ext_crypt_cs_cytcp::gmcsf	ext_crypt_cs_cytcp::gmcsf	NA	NA	
ext_crypt_cs_cytcp::ifng	ext_crypt_cs_cytcp::ifng	NA	NA	
ext_crypt_cs_cytcp::il10	ext_crypt_cs_cytcp::il10	NA	NA	
ext_crypt_cs_cytcp::il12p70	ext_crypt_cs_cytcp::il12p70	NA	NA	
ext_crypt_cs_cytcp::il13	ext_crypt_cs_cytcp::il13	NA	NA	
ext_crypt_cs_cytcp::il17a	ext_crypt_cs_cytcp::il17a	NA	NA	
ext_crypt_cs_cytcp::il1b	ext_crypt_cs_cytcp::il1b	NA	NA	
ext_crypt_cs_cytcp::il2	ext_crypt_cs_cytcp::il2	NA	NA	
ext_crypt_cs_cytcp::il4	ext_crypt_cs_cytcp::il4	NA	NA	
ext_crypt_cs_cytcp::il5	ext_crypt_cs_cytcp::il5	NA	NA	
ext_crypt_cs_cytcp::il6	ext_crypt_cs_cytcp::il6	NA	NA	
ext_crypt_cs_cytcp::il7	ext_crypt_cs_cytcp::il7	NA	NA	
ext_crypt_cs_cytcp::il8	ext_crypt_cs_cytcp::il8	NA	NA	
ext_crypt_cs_cytcp::mcp1	ext_crypt_cs_cytcp::mcp1	NA	NA	
ext_crypt_cs_cytcp::mip1b	ext_crypt_cs_cytcp::mip1b	NA	NA	
ext_crypt_cs_cytcp::site	ext_crypt_cs_cytcp::site	NA	NA	
ext_crypt_cs_cytcp::specdt	ext_crypt_cs_cytcp::specdt	NA	NA	
ext_crypt_cs_cytcp::specseq	ext_crypt_cs_cytcp::specseq	NA	NA	
ext_crypt_cs_cytcp::tnfa	ext_crypt_cs_cytcp::tnfa	NA	NA	
ext_crypt_cs_cytmp::gcsf	ext_crypt_cs_cytmp::gcsf	NA	NA	
ext_crypt_cs_cytmp::gmcsf	ext_crypt_cs_cytmp::gmcsf	NA	NA	
ext_crypt_cs_cytmp::ifng	ext_crypt_cs_cytmp::ifng	NA	NA	
ext_crypt_cs_cytmp::il10	ext_crypt_cs_cytmp::il10	NA	NA	
ext_crypt_cs_cytmp::il12p70	ext_crypt_cs_cytmp::il12p70	NA	NA	
ext_crypt_cs_cytmp::il13	ext_crypt_cs_cytmp::il13	NA	NA	
ext_crypt_cs_cytmp::il17a	ext_crypt_cs_cytmp::il17a	NA	NA	
ext_crypt_cs_cytmp::il1b	ext_crypt_cs_cytmp::il1b	NA	NA	
ext_crypt_cs_cytmp::il2	ext_crypt_cs_cytmp::il2	NA	NA	
ext_crypt_cs_cytmp::il4	ext_crypt_cs_cytmp::il4	NA	NA	
ext_crypt_cs_cytmp::il5	ext_crypt_cs_cytmp::il5	NA	NA	
ext_crypt_cs_cytmp::il6	ext_crypt_cs_cytmp::il6	NA	NA	
ext_crypt_cs_cytmp::il7	ext_crypt_cs_cytmp::il7	NA	NA	
ext_crypt_cs_cytmp::il8	ext_crypt_cs_cytmp::il8	NA	NA	
ext_crypt_cs_cytmp::mcp1	ext_crypt_cs_cytmp::mcp1	NA	NA	
ext_crypt_cs_cytmp::mip1b	ext_crypt_cs_cytmp::mip1b	NA	NA	
ext_crypt_cs_cytmp::specdt	ext_crypt_cs_cytmp::specdt	NA	NA	
ext_crypt_cs_cytmp::tnfa	ext_crypt_cs_cytmp::tnfa	NA	NA	
ext_crypt_cs_egf_bmilk::specdt	ext_crypt_cs_egf_bmilk::specdt	NA	NA	
ext_crypt_cs_egf_bmilk::visit	ext_crypt_cs_egf_bmilk::visit	NA	NA	
ext_crypt_cs_il1b::aged	ext_crypt_cs_il1b::aged	NA	NA	
ext_crypt_cs_il1b::il1b	ext_crypt_cs_il1b::il1b	NA	NA	
ext_crypt_cs_il1b::specdt	ext_crypt_cs_il1b::specdt	NA	NA	
ext_crypt_cs_il4::aged	ext_crypt_cs_il4::aged	NA	NA	
ext_crypt_cs_il4::specdt	ext_crypt_cs_il4::specdt	NA	NA	
ext_crypt_cs_lm::aged	ext_crypt_cs_lm::aged	NA	NA	
ext_crypt_cs_lm::specdt	ext_crypt_cs_lm::specdt	NA	NA	
ext_crypt_cs_mpo_infant::aged	ext_crypt_cs_mpo_infant::aged	NA	NA	
ext_crypt_cs_mpo_infant::specdt	ext_crypt_cs_mpo_infant::specdt	NA	NA	
ext_crypt_cs_mpo_mother::specdt	ext_crypt_cs_mpo_mother::specdt	NA	NA	
ext_crypt_cs_mpo_mother::visit	ext_crypt_cs_mpo_mother::visit	NA	NA	
ext_crypt_cs_polio_sna::sabin.1	ext_crypt_cs_polio_sna::sabin.1	NA	NA	
ext_crypt_cs_polio_sna::sabin.2	ext_crypt_cs_polio_sna::sabin.2	NA	NA	
ext_crypt_cs_polio_sna::sabin.3	ext_crypt_cs_polio_sna::sabin.3	NA	NA	
ext_crypt_cs_polio_sna::seranum	ext_crypt_cs_polio_sna::seranum	NA	NA	
ext_crypt_cs_reg1b_infant::aged	ext_crypt_cs_reg1b_infant::aged	NA	NA	
ext_crypt_cs_reg1b_infant::specdt	ext_crypt_cs_reg1b_infant::specdt	NA	NA	
ext_crypt_cs_reg1b_mother::specdt	ext_crypt_cs_reg1b_mother::specdt	NA	NA	
ext_crypt_cs_reg1b_mother::visit	ext_crypt_cs_reg1b_mother::visit	NA	NA	
ext_crypt_cs_retinol::aged	ext_crypt_cs_retinol::aged	NA	NA	
ext_crypt_cs_retinol::specdt	ext_crypt_cs_retinol::specdt	NA	NA	
ext_crypt_cs_scd14::aged	ext_crypt_cs_scd14::aged	NA	NA	
ext_crypt_cs_scd14::specdt	ext_crypt_cs_scd14::specdt	NA	NA	
ext_crypt_cs_sspa::specdt	ext_crypt_cs_sspa::specdt	NA	NA	
ext_crypt_cs_sspa::visit	ext_crypt_cs_sspa::visit	NA	NA	
ext_crypt_cs_stool_iga_month12::aged	ext_crypt_cs_stool_iga_month12::aged	NA	NA	
ext_crypt_cs_stool_iga_month12::specdt	ext_crypt_cs_stool_iga_month12::specdt	NA	NA	
ext_crypt_cs_stool_iga_month4::aged	ext_crypt_cs_stool_iga_month4::aged	NA	NA	
ext_crypt_cs_stool_iga_month4::specdt	ext_crypt_cs_stool_iga_month4::specdt	NA	NA	
ext_crypt_cs_tac::dsno	ext_crypt_cs_tac::dsno	NA	NA	
ext_crypt_cs_zn::aged	ext_crypt_cs_zn::aged	NA	NA	
ext_crypt_cs_zn::specdt	ext_crypt_cs_zn::specdt	NA	NA	
ext_crypt_ctreat::dov	ext_crypt_ctreat::dov	NA	NA	
ext_crypt_ctreat::enddate1	ext_crypt_ctreat::enddate1	NA	NA	
ext_crypt_ctreat::enddate2	ext_crypt_ctreat::enddate2	NA	NA	
ext_crypt_ctreat::enddate4	ext_crypt_ctreat::enddate4	NA	NA	
ext_crypt_ctreat::enddate5	ext_crypt_ctreat::enddate5	NA	NA	
ext_crypt_ctreat::enddate6	ext_crypt_ctreat::enddate6	NA	NA	
ext_crypt_ctreat::other	ext_crypt_ctreat::other	NA	NA	
ext_crypt_ctreat::temp	ext_crypt_ctreat::temp	NA	NA	
ext_crypt_ctreat::treat1	ext_crypt_ctreat::treat1	NA	NA	
ext_crypt_ctreat::treat10	ext_crypt_ctreat::treat10	NA	NA	
ext_crypt_ctreat::treat2	ext_crypt_ctreat::treat2	NA	NA	
ext_crypt_ctreat::treat3	ext_crypt_ctreat::treat3	NA	NA	
ext_crypt_ctreat::treat4	ext_crypt_ctreat::treat4	NA	NA	
ext_crypt_ctreat::treat5	ext_crypt_ctreat::treat5	NA	NA	
ext_crypt_ctreat::treat6	ext_crypt_ctreat::treat6	NA	NA	
ext_crypt_ctreat::treat7	ext_crypt_ctreat::treat7	NA	NA	
ext_crypt_ctreat::treat8	ext_crypt_ctreat::treat8	NA	NA	
ext_crypt_ctreat::treat9	ext_crypt_ctreat::treat9	NA	NA	
ext_crypt_mgmt_breastfeeding::anybfd	ext_crypt_mgmt_breastfeeding::anybfd	NA	NA	
ext_crypt_mgmt_breastfeeding::dyexbfstrt	ext_crypt_mgmt_breastfeeding::dyexbfstrt	NA	NA	
ext_crypt_mgmt_breastfeeding::exlbf	ext_crypt_mgmt_breastfeeding::exlbf	NA	NA	
ext_crypt_mgmt_lmr::lexret	ext_crypt_mgmt_lmr::lexret	NA	NA	
ext_crypt_mgmt_lmr::lintake	ext_crypt_mgmt_lmr::lintake	NA	NA	
ext_crypt_mgmt_lmr::lmadmml	ext_crypt_mgmt_lmr::lmadmml	NA	NA	
ext_crypt_mgmt_lmr::lmdoc	ext_crypt_mgmt_lmr::lmdoc	NA	NA	
ext_crypt_mgmt_lmr::lmratio	ext_crypt_mgmt_lmr::lmratio	NA	NA	
ext_crypt_mgmt_lmr::lurin	ext_crypt_mgmt_lmr::lurin	NA	NA	
ext_crypt_mgmt_lmr::mexret	ext_crypt_mgmt_lmr::mexret	NA	NA	
ext_crypt_mgmt_lmr::mintake	ext_crypt_mgmt_lmr::mintake	NA	NA	
ext_crypt_mgmt_lmr::murin	ext_crypt_mgmt_lmr::murin	NA	NA	
ext_crypt_mgmt_lmr::ulrecv	ext_crypt_mgmt_lmr::ulrecv	NA	NA	
ext_crypt_mgmt_lmr::umrecv	ext_crypt_mgmt_lmr::umrecv	NA	NA	
ext_crypt_mgmt_lmr::urinml	ext_crypt_mgmt_lmr::urinml	NA	NA	
ext_crypt_neb_sws::daynebuse	ext_crypt_neb_sws::daynebuse	NA	NA	
ext_crypt_neb_sws::nbstrtdt	ext_crypt_neb_sws::nbstrtdt	NA	NA	
ext_crypt_neb_sws::neb_freq	ext_crypt_neb_sws::neb_freq	NA	NA	
ext_crypt_neb_sws::wtkg	ext_crypt_neb_sws::wtkg	NA	NA	
ext_crypt_sb_btest::dop	ext_crypt_sb_btest::dop	NA	NA	
ext_crypt_sb_btest::ht	ext_crypt_sb_btest::ht	NA	NA	
ext_crypt_sb_btest::q4a	ext_crypt_sb_btest::q4a	NA	NA	
ext_crypt_sb_btest::q4b_cd	ext_crypt_sb_btest::q4b_cd	NA	NA	
ext_crypt_sb_btest::q4b_hd	ext_crypt_sb_btest::q4b_hd	NA	NA	
ext_crypt_sb_btest::q4b_mt	ext_crypt_sb_btest::q4b_mt	NA	NA	
ext_crypt_sb_btest::q4c	ext_crypt_sb_btest::q4c	NA	NA	
ext_crypt_sb_btest::q4d	ext_crypt_sb_btest::q4d	NA	NA	
ext_crypt_sb_btest::qe_cd20	ext_crypt_sb_btest::qe_cd20	NA	NA	
ext_crypt_sb_btest::qe_hd20	ext_crypt_sb_btest::qe_hd20	NA	NA	
ext_crypt_sb_btest::qe_mt20	ext_crypt_sb_btest::qe_mt20	NA	NA	
ext_crypt_sb_btest::qf_cd40	ext_crypt_sb_btest::qf_cd40	NA	NA	
ext_crypt_sb_btest::qf_hd40	ext_crypt_sb_btest::qf_hd40	NA	NA	
ext_crypt_sb_btest::qf_mt40	ext_crypt_sb_btest::qf_mt40	NA	NA	
ext_crypt_sb_btest::qg_cd60	ext_crypt_sb_btest::qg_cd60	NA	NA	
ext_crypt_sb_btest::qg_hd60	ext_crypt_sb_btest::qg_hd60	NA	NA	
ext_crypt_sb_btest::qg_mt60	ext_crypt_sb_btest::qg_mt60	NA	NA	
ext_crypt_sb_btest::qh_cd80	ext_crypt_sb_btest::qh_cd80	NA	NA	
ext_crypt_sb_btest::qh_hd80	ext_crypt_sb_btest::qh_hd80	NA	NA	
ext_crypt_sb_btest::qh_mt80	ext_crypt_sb_btest::qh_mt80	NA	NA	
ext_crypt_sb_btest::qi_cd100	ext_crypt_sb_btest::qi_cd100	NA	NA	
ext_crypt_sb_btest::qi_hd100	ext_crypt_sb_btest::qi_hd100	NA	NA	
ext_crypt_sb_btest::qi_mt100	ext_crypt_sb_btest::qi_mt100	NA	NA	
ext_crypt_sb_btest::qj_cd120	ext_crypt_sb_btest::qj_cd120	NA	NA	
ext_crypt_sb_btest::qj_hd120	ext_crypt_sb_btest::qj_hd120	NA	NA	
ext_crypt_sb_btest::qj_mt120	ext_crypt_sb_btest::qj_mt120	NA	NA	
ext_crypt_sb_btest::qk_cd140	ext_crypt_sb_btest::qk_cd140	NA	NA	
ext_crypt_sb_btest::qk_hd140	ext_crypt_sb_btest::qk_hd140	NA	NA	
ext_crypt_sb_btest::qk_mt140	ext_crypt_sb_btest::qk_mt140	NA	NA	
ext_crypt_sb_btest::ql_cd160	ext_crypt_sb_btest::ql_cd160	NA	NA	
ext_crypt_sb_btest::ql_hd160	ext_crypt_sb_btest::ql_hd160	NA	NA	
ext_crypt_sb_btest::ql_mt160	ext_crypt_sb_btest::ql_mt160	NA	NA	
ext_crypt_sb_btest::qm_cd180	ext_crypt_sb_btest::qm_cd180	NA	NA	
ext_crypt_sb_btest::qm_hd180	ext_crypt_sb_btest::qm_hd180	NA	NA	
ext_crypt_sb_btest::qm_mt180	ext_crypt_sb_btest::qm_mt180	NA	NA	
ext_crypt_sb_btest::wt	ext_crypt_sb_btest::wt	NA	NA	
ext_crypt_sb_btestr::dop	ext_crypt_sb_btestr::dop	NA	NA	
ext_crypt_sb_btestr::ht	ext_crypt_sb_btestr::ht	NA	NA	
ext_crypt_sb_btestr::q4a	ext_crypt_sb_btestr::q4a	NA	NA	
ext_crypt_sb_btestr::q4b_cd	ext_crypt_sb_btestr::q4b_cd	NA	NA	
ext_crypt_sb_btestr::q4b_hd	ext_crypt_sb_btestr::q4b_hd	NA	NA	
ext_crypt_sb_btestr::q4b_mt	ext_crypt_sb_btestr::q4b_mt	NA	NA	
ext_crypt_sb_btestr::q4c	ext_crypt_sb_btestr::q4c	NA	NA	
ext_crypt_sb_btestr::q4d	ext_crypt_sb_btestr::q4d	NA	NA	
ext_crypt_sb_btestr::q5b	ext_crypt_sb_btestr::q5b	NA	NA	
ext_crypt_sb_btestr::qe_cd20	ext_crypt_sb_btestr::qe_cd20	NA	NA	
ext_crypt_sb_btestr::qe_hd20	ext_crypt_sb_btestr::qe_hd20	NA	NA	
ext_crypt_sb_btestr::qe_mt20	ext_crypt_sb_btestr::qe_mt20	NA	NA	
ext_crypt_sb_btestr::qf_cd40	ext_crypt_sb_btestr::qf_cd40	NA	NA	
ext_crypt_sb_btestr::qf_hd40	ext_crypt_sb_btestr::qf_hd40	NA	NA	
ext_crypt_sb_btestr::qf_mt40	ext_crypt_sb_btestr::qf_mt40	NA	NA	
ext_crypt_sb_btestr::qg_cd60	ext_crypt_sb_btestr::qg_cd60	NA	NA	
ext_crypt_sb_btestr::qg_hd60	ext_crypt_sb_btestr::qg_hd60	NA	NA	
ext_crypt_sb_btestr::qg_mt60	ext_crypt_sb_btestr::qg_mt60	NA	NA	
ext_crypt_sb_btestr::qh_cd80	ext_crypt_sb_btestr::qh_cd80	NA	NA	
ext_crypt_sb_btestr::qh_hd80	ext_crypt_sb_btestr::qh_hd80	NA	NA	
ext_crypt_sb_btestr::qh_mt80	ext_crypt_sb_btestr::qh_mt80	NA	NA	
ext_crypt_sb_btestr::qi_cd100	ext_crypt_sb_btestr::qi_cd100	NA	NA	
ext_crypt_sb_btestr::qi_hd100	ext_crypt_sb_btestr::qi_hd100	NA	NA	
ext_crypt_sb_btestr::qi_mt100	ext_crypt_sb_btestr::qi_mt100	NA	NA	
ext_crypt_sb_btestr::qj_cd120	ext_crypt_sb_btestr::qj_cd120	NA	NA	
ext_crypt_sb_btestr::qj_hd120	ext_crypt_sb_btestr::qj_hd120	NA	NA	
ext_crypt_sb_btestr::qj_mt120	ext_crypt_sb_btestr::qj_mt120	NA	NA	
ext_crypt_sb_btestr::qk_cd140	ext_crypt_sb_btestr::qk_cd140	NA	NA	
ext_crypt_sb_btestr::qk_hd140	ext_crypt_sb_btestr::qk_hd140	NA	NA	
ext_crypt_sb_btestr::qk_mt140	ext_crypt_sb_btestr::qk_mt140	NA	NA	
ext_crypt_sb_btestr::ql_cd160	ext_crypt_sb_btestr::ql_cd160	NA	NA	
ext_crypt_sb_btestr::ql_hd160	ext_crypt_sb_btestr::ql_hd160	NA	NA	
ext_crypt_sb_btestr::ql_mt160	ext_crypt_sb_btestr::ql_mt160	NA	NA	
ext_crypt_sb_btestr::qm_cd180	ext_crypt_sb_btestr::qm_cd180	NA	NA	
ext_crypt_sb_btestr::qm_hd180	ext_crypt_sb_btestr::qm_hd180	NA	NA	
ext_crypt_sb_btestr::qm_mt180	ext_crypt_sb_btestr::qm_mt180	NA	NA	
ext_crypt_sb_btestr::sb_num	ext_crypt_sb_btestr::sb_num	NA	NA	
ext_crypt_sb_btestr::wt	ext_crypt_sb_btestr::wt	NA	NA	
ext_crypt_sb_fuv::circum	ext_crypt_sb_fuv::circum	NA	NA	
ext_crypt_sb_fuv::dov	ext_crypt_sb_fuv::dov	NA	NA	
ext_crypt_sb_fuv::ht	ext_crypt_sb_fuv::ht	NA	NA	
ext_crypt_sb_fuv::q6a	ext_crypt_sb_fuv::q6a	NA	NA	
ext_crypt_sb_fuv::q6e	ext_crypt_sb_fuv::q6e	NA	NA	
ext_crypt_sb_fuv::q6f	ext_crypt_sb_fuv::q6f	NA	NA	
ext_crypt_sb_fuv::q6g	ext_crypt_sb_fuv::q6g	NA	NA	
ext_crypt_sb_fuv::q6h	ext_crypt_sb_fuv::q6h	NA	NA	
ext_crypt_sb_fuv::q7c	ext_crypt_sb_fuv::q7c	NA	NA	
ext_crypt_sb_fuv::q7d	ext_crypt_sb_fuv::q7d	NA	NA	
ext_crypt_sb_fuv::q8c	ext_crypt_sb_fuv::q8c	NA	NA	
ext_crypt_sb_fuv::q9c	ext_crypt_sb_fuv::q9c	NA	NA	
ext_crypt_sb_fuv::wt	ext_crypt_sb_fuv::wt	NA	NA	
ext_crypt_wztalsc::dov	ext_crypt_wztalsc::dov	NA	NA	
ext_crypt_wztalsc::total	ext_crypt_wztalsc::total	NA	NA	
ext_crypt_wztalsc::visitnum	ext_crypt_wztalsc::visitnum	NA	NA	
ext_crypt_wztrack::doi	ext_crypt_wztrack::doi	NA	NA	
ext_crypt_wztrack::enddate	ext_crypt_wztrack::enddate	NA	NA	
ext_crypt_wztrack::strtdate	ext_crypt_wztrack::strtdate	NA	NA	
ext_crypto_cenr_2000::dob	ext_crypto_cenr_2000::dob	NA	NA	
ext_crypto_cenr_2000::doc	ext_crypto_cenr_2000::doc	NA	NA	
ext_crypto_cenr_2000::doe	ext_crypto_cenr_2000::doe	NA	NA	
ext_crypto_cenr_3000::dob	ext_crypto_cenr_3000::dob	NA	NA	
ext_crypto_cenr_3000::doc	ext_crypto_cenr_3000::doc	NA	NA	
ext_crypto_cenr_3000::doe	ext_crypto_cenr_3000::doe	NA	NA	
ext_crypto_cr_anthro_2000::dob	ext_crypto_cr_anthro_2000::dob	NA	NA	
ext_crypto_cr_anthro_3000::dob	ext_crypto_cr_anthro_3000::dob	NA	NA	
ext_crypto_cr_cbl_2000::amount	ext_crypto_cr_cbl_2000::amount	NA	NA	
ext_crypto_cr_cbl_3000::amount	ext_crypto_cr_cbl_3000::amount	NA	NA	
ext_crypto_cr_diarep_2000::diarend	ext_crypto_cr_diarep_2000::diarend	NA	NA	
ext_crypto_cr_diarep_2000::diarstrt	ext_crypto_cr_diarep_2000::diarstrt	NA	NA	
ext_crypto_cr_diarep_2000::doi	ext_crypto_cr_diarep_2000::doi	NA	NA	
ext_crypto_cr_diarep_2000::wt	ext_crypto_cr_diarep_2000::wt	NA	NA	
ext_crypto_cr_diarep_3000::diarend	ext_crypto_cr_diarep_3000::diarend	NA	NA	
ext_crypto_cr_diarep_3000::diarstrt	ext_crypto_cr_diarep_3000::diarstrt	NA	NA	
ext_crypto_cr_diarep_3000::doi	ext_crypto_cr_diarep_3000::doi	NA	NA	
ext_crypto_cr_diarep_3000::wt	ext_crypto_cr_diarep_3000::wt	NA	NA	
ext_crypto_cr_diarr_2000::doc	ext_crypto_cr_diarr_2000::doc	NA	NA	
ext_crypto_cr_diarr_2000::st24hr	ext_crypto_cr_diarr_2000::st24hr	NA	NA	
ext_crypto_cr_diarr_2000::vomi	ext_crypto_cr_diarr_2000::vomi	NA	NA	
ext_crypto_cr_diarr_3000::site	ext_crypto_cr_diarr_3000::site	NA	NA	
ext_crypto_cr_diarr_3000::st24hr	ext_crypto_cr_diarr_3000::st24hr	NA	NA	
ext_crypto_cr_diarr_3000::vomi	ext_crypto_cr_diarr_3000::vomi	NA	NA	
ext_crypto_cr_ds_2000::doc	ext_crypto_cr_ds_2000::doc	NA	NA	
ext_crypto_cr_ds_2000::dsno	ext_crypto_cr_ds_2000::dsno	NA	NA	
ext_crypto_cr_ds_2000::specid	ext_crypto_cr_ds_2000::specid	NA	NA	
ext_crypto_cr_ds_3000::doc	ext_crypto_cr_ds_3000::doc	NA	NA	
ext_crypto_cr_ds_3000::dsno	ext_crypto_cr_ds_3000::dsno	NA	NA	
ext_crypto_cr_ds_3000::specid	ext_crypto_cr_ds_3000::specid	NA	NA	
ext_crypto_cr_ga_3000::ga_wks	ext_crypto_cr_ga_3000::ga_wks	NA	NA	
ext_crypto_cr_gaa_2000::doi	ext_crypto_cr_gaa_2000::doi	NA	NA	
ext_crypto_cr_gaa_2000::g_age	ext_crypto_cr_gaa_2000::g_age	NA	NA	
ext_crypto_cr_gaa_2000::heel	ext_crypto_cr_gaa_2000::heel	NA	NA	
ext_crypto_cr_gaa_2000::score	ext_crypto_cr_gaa_2000::score	NA	NA	
ext_crypto_cr_mbl_2000::specid	ext_crypto_cr_mbl_2000::specid	NA	NA	
ext_crypto_cr_mbl_3000::specid	ext_crypto_cr_mbl_3000::specid	NA	NA	
ext_crypto_cr_mbm_2000::specid	ext_crypto_cr_mbm_2000::specid	NA	NA	
ext_crypto_cr_mbm_3000::specid	ext_crypto_cr_mbm_3000::specid	NA	NA	
ext_crypto_cr_ms_2000::msno	ext_crypto_cr_ms_2000::msno	NA	NA	
ext_crypto_cr_ms_2000::specid	ext_crypto_cr_ms_2000::specid	NA	NA	
ext_crypto_cr_ms_3000::msno	ext_crypto_cr_ms_3000::msno	NA	NA	
ext_crypto_cr_ms_3000::specid	ext_crypto_cr_ms_3000::specid	NA	NA	
ext_crypto_cr_msf_3000::specid	ext_crypto_cr_msf_3000::specid	NA	NA	
ext_crypto_cr_ter_2000::doi	ext_crypto_cr_ter_2000::doi	NA	NA	
ext_crypto_cr_ter_2000::dtdsc	ext_crypto_cr_ter_2000::dtdsc	NA	NA	
ext_crypto_cr_ter_3000::doi	ext_crypto_cr_ter_3000::doi	NA	NA	
ext_crypto_cr_ter_3000::dtdsc	ext_crypto_cr_ter_3000::dtdsc	NA	NA	
ext_crypto_ds_rt_2000::cryctrt	ext_crypto_ds_rt_2000::cryctrt	NA	NA	
ext_crypto_ds_rt_2000::doc	ext_crypto_ds_rt_2000::doc	NA	NA	
ext_crypto_ds_rt_2000::dsno	ext_crypto_ds_rt_2000::dsno	NA	NA	
ext_crypto_ds_rt_2000::ehctrt	ext_crypto_ds_rt_2000::ehctrt	NA	NA	
ext_crypto_ds_rt_2000::giactrt	ext_crypto_ds_rt_2000::giactrt	NA	NA	
ext_crypto_ds_rt_2000::specid	ext_crypto_ds_rt_2000::specid	NA	NA	
ext_crypto_ds_rt_3000::cryctrt	ext_crypto_ds_rt_3000::cryctrt	NA	NA	
ext_crypto_ds_rt_3000::doc	ext_crypto_ds_rt_3000::doc	NA	NA	
ext_crypto_ds_rt_3000::dsno	ext_crypto_ds_rt_3000::dsno	NA	NA	
ext_crypto_ds_rt_3000::ehctrt	ext_crypto_ds_rt_3000::ehctrt	NA	NA	
ext_crypto_ds_rt_3000::giactrt	ext_crypto_ds_rt_3000::giactrt	NA	NA	
ext_crypto_ds_rt_3000::specid	ext_crypto_ds_rt_3000::specid	NA	NA	
ext_crypto_dsmicro_2000::doc	ext_crypto_dsmicro_2000::doc	NA	NA	
ext_crypto_dsmicro_2000::dsno	ext_crypto_dsmicro_2000::dsno	NA	NA	
ext_crypto_dsmicro_2000::specid	ext_crypto_dsmicro_2000::specid	NA	NA	
ext_crypto_dsmicro_3000::doc	ext_crypto_dsmicro_3000::doc	NA	NA	
ext_crypto_dsmicro_3000::dsno	ext_crypto_dsmicro_3000::dsno	NA	NA	
ext_crypto_dsmicro_3000::specid	ext_crypto_dsmicro_3000::specid	NA	NA	
ext_crypto_enr7mo_3000::age	ext_crypto_enr7mo_3000::age	NA	NA	
ext_crypto_enr7mo_3000::age_marr	ext_crypto_enr7mo_3000::age_marr	NA	NA	
ext_crypto_enr7mo_3000::age_mena	ext_crypto_enr7mo_3000::age_mena	NA	NA	
ext_crypto_enr7mo_3000::age1preg	ext_crypto_enr7mo_3000::age1preg	NA	NA	
ext_crypto_enr7mo_3000::doc	ext_crypto_enr7mo_3000::doc	NA	NA	
ext_crypto_enr7mo_3000::doe	ext_crypto_enr7mo_3000::doe	NA	NA	
ext_crypto_enr7mo_3000::ht	ext_crypto_enr7mo_3000::ht	NA	NA	
ext_crypto_enr7mo_3000::muac	ext_crypto_enr7mo_3000::muac	NA	NA	
ext_crypto_enr7mo_3000::n_living	ext_crypto_enr7mo_3000::n_living	NA	NA	
ext_crypto_enr7mo_3000::n_marr	ext_crypto_enr7mo_3000::n_marr	NA	NA	
ext_crypto_enr7mo_3000::n_stillb	ext_crypto_enr7mo_3000::n_stillb	NA	NA	
ext_crypto_enr7mo_3000::tt	ext_crypto_enr7mo_3000::tt	NA	NA	
ext_crypto_enr7mo_3000::vtype	ext_crypto_enr7mo_3000::vtype	NA	NA	
ext_crypto_enr7mo_3000::wt	ext_crypto_enr7mo_3000::wt	NA	NA	
ext_crypto_manthro_2000::bmi	ext_crypto_manthro_2000::bmi	NA	NA	
ext_crypto_manthro_3000::bmi	ext_crypto_manthro_3000::bmi	NA	NA	
ext_crypto_menr_2000::age	ext_crypto_menr_2000::age	NA	NA	
ext_crypto_menr_2000::age_marr	ext_crypto_menr_2000::age_marr	NA	NA	
ext_crypto_menr_2000::age_mena	ext_crypto_menr_2000::age_mena	NA	NA	
ext_crypto_menr_2000::age1preg	ext_crypto_menr_2000::age1preg	NA	NA	
ext_crypto_menr_2000::dob_m	ext_crypto_menr_2000::dob_m	NA	NA	
ext_crypto_menr_2000::doe	ext_crypto_menr_2000::doe	NA	NA	
ext_crypto_menr_2000::n_living	ext_crypto_menr_2000::n_living	NA	NA	
ext_crypto_menr_2000::n_marr	ext_crypto_menr_2000::n_marr	NA	NA	
ext_crypto_menr_2000::n_stillb	ext_crypto_menr_2000::n_stillb	NA	NA	
ext_crypto_menr_2000::tt	ext_crypto_menr_2000::tt	NA	NA	
ext_crypto_mgmt_cranthz_2000::dob	ext_crypto_mgmt_cranthz_2000::dob	NA	NA	
ext_crypto_mgmt_cranthz_2000::doc	ext_crypto_mgmt_cranthz_2000::doc	NA	NA	
ext_crypto_mgmt_cranthz_2000::muacz	ext_crypto_mgmt_cranthz_2000::muacz	NA	NA	
ext_crypto_mgmt_cranthz_3000::aged	ext_crypto_mgmt_cranthz_3000::aged	NA	NA	
ext_crypto_mgmt_cranthz_3000::dob	ext_crypto_mgmt_cranthz_3000::dob	NA	NA	
ext_crypto_mgmt_cranthz_3000::doc	ext_crypto_mgmt_cranthz_3000::doc	NA	NA	
ext_crypto_mgmt_cranthz_3000::muacz	ext_crypto_mgmt_cranthz_3000::muacz	NA	NA	
ext_crypto_mgmt_diarepi_dur_2000::dirend	ext_crypto_mgmt_diarepi_dur_2000::dirend	NA	NA	
ext_crypto_mgmt_diarepi_dur_2000::dirstrt	ext_crypto_mgmt_diarepi_dur_2000::dirstrt	NA	NA	
ext_crypto_mgmt_diarepi_dur_2000::duration	ext_crypto_mgmt_diarepi_dur_2000::duration	NA	NA	
ext_crypto_mgmt_diarepi_dur_2000::epinum	ext_crypto_mgmt_diarepi_dur_2000::epinum	NA	NA	
ext_crypto_mgmt_diarepi_dur_3000::depidays	ext_crypto_mgmt_diarepi_dur_3000::depidays	NA	NA	
ext_crypto_mgmt_diarepi_dur_3000::dirend	ext_crypto_mgmt_diarepi_dur_3000::dirend	NA	NA	
ext_crypto_mgmt_diarepi_dur_3000::dirstrt	ext_crypto_mgmt_diarepi_dur_3000::dirstrt	NA	NA	
ext_crypto_mgmt_diarepi_dur_3000::duration	ext_crypto_mgmt_diarepi_dur_3000::duration	NA	NA	
ext_crypto_mgmt_diarepi_dur_3000::epinum	ext_crypto_mgmt_diarepi_dur_3000::epinum	NA	NA	
ext_crypto_ms_rt_2000::cryctrt	ext_crypto_ms_rt_2000::cryctrt	NA	NA	
ext_crypto_ms_rt_2000::doc	ext_crypto_ms_rt_2000::doc	NA	NA	
ext_crypto_ms_rt_2000::ehctrt	ext_crypto_ms_rt_2000::ehctrt	NA	NA	
ext_crypto_ms_rt_2000::giactrt	ext_crypto_ms_rt_2000::giactrt	NA	NA	
ext_crypto_ms_rt_2000::msno	ext_crypto_ms_rt_2000::msno	NA	NA	
ext_crypto_ms_rt_2000::specid	ext_crypto_ms_rt_2000::specid	NA	NA	
ext_crypto_ms_rt_3000::cryctrt	ext_crypto_ms_rt_3000::cryctrt	NA	NA	
ext_crypto_ms_rt_3000::doc	ext_crypto_ms_rt_3000::doc	NA	NA	
ext_crypto_ms_rt_3000::ehctrt	ext_crypto_ms_rt_3000::ehctrt	NA	NA	
ext_crypto_ms_rt_3000::giactrt	ext_crypto_ms_rt_3000::giactrt	NA	NA	
ext_crypto_ms_rt_3000::msno	ext_crypto_ms_rt_3000::msno	NA	NA	
ext_crypto_ms_rt_3000::specid	ext_crypto_ms_rt_3000::specid	NA	NA	
ext_crypto_ses_2000::agent_b	ext_crypto_ses_2000::agent_b	NA	NA	
ext_crypto_ses_2000::agent_c	ext_crypto_ses_2000::agent_c	NA	NA	
ext_crypto_ses_2000::agent_d	ext_crypto_ses_2000::agent_d	NA	NA	
ext_crypto_ses_2000::agent_e	ext_crypto_ses_2000::agent_e	NA	NA	
ext_crypto_ses_2000::children	ext_crypto_ses_2000::children	NA	NA	
ext_crypto_ses_2000::doi	ext_crypto_ses_2000::doi	NA	NA	
ext_crypto_ses_2000::expn	ext_crypto_ses_2000::expn	NA	NA	
ext_crypto_ses_2000::f_edu	ext_crypto_ses_2000::f_edu	NA	NA	
ext_crypto_ses_2000::f_occu	ext_crypto_ses_2000::f_occu	NA	NA	
ext_crypto_ses_2000::h_income	ext_crypto_ses_2000::h_income	NA	NA	
ext_crypto_ses_2000::hh_expen	ext_crypto_ses_2000::hh_expen	NA	NA	
ext_crypto_ses_2000::hh_rent	ext_crypto_ses_2000::hh_rent	NA	NA	
ext_crypto_ses_2000::how_b	ext_crypto_ses_2000::how_b	NA	NA	
ext_crypto_ses_2000::how_c	ext_crypto_ses_2000::how_c	NA	NA	
ext_crypto_ses_2000::how_d	ext_crypto_ses_2000::how_d	NA	NA	
ext_crypto_ses_2000::how_e	ext_crypto_ses_2000::how_e	NA	NA	
ext_crypto_ses_2000::income	ext_crypto_ses_2000::income	NA	NA	
ext_crypto_ses_2000::m_edu	ext_crypto_ses_2000::m_edu	NA	NA	
ext_crypto_ses_2000::m_income	ext_crypto_ses_2000::m_income	NA	NA	
ext_crypto_ses_2000::m_occu	ext_crypto_ses_2000::m_occu	NA	NA	
ext_crypto_ses_2000::member	ext_crypto_ses_2000::member	NA	NA	
ext_crypto_ses_2000::n_room	ext_crypto_ses_2000::n_room	NA	NA	
ext_crypto_ses_2000::o_expen	ext_crypto_ses_2000::o_expen	NA	NA	
ext_crypto_ses_2000::o_income	ext_crypto_ses_2000::o_income	NA	NA	
ext_crypto_ses_2000::ownhh	ext_crypto_ses_2000::ownhh	NA	NA	
ext_crypto_ses_2000::s_income	ext_crypto_ses_2000::s_income	NA	NA	
ext_crypto_ses_2000::sibling	ext_crypto_ses_2000::sibling	NA	NA	
ext_crypto_ses_2000::sleep	ext_crypto_ses_2000::sleep	NA	NA	
ext_crypto_ses_2000::souce_c	ext_crypto_ses_2000::souce_c	NA	NA	
ext_crypto_ses_2000::source_b	ext_crypto_ses_2000::source_b	NA	NA	
ext_crypto_ses_2000::source_d	ext_crypto_ses_2000::source_d	NA	NA	
ext_crypto_ses_2000::source_e	ext_crypto_ses_2000::source_e	NA	NA	
ext_crypto_ses_2000::toilet_sh	ext_crypto_ses_2000::toilet_sh	NA	NA	
ext_crypto_ses_3000::agent_b	ext_crypto_ses_3000::agent_b	NA	NA	
ext_crypto_ses_3000::agent_c	ext_crypto_ses_3000::agent_c	NA	NA	
ext_crypto_ses_3000::agent_d	ext_crypto_ses_3000::agent_d	NA	NA	
ext_crypto_ses_3000::agent_e	ext_crypto_ses_3000::agent_e	NA	NA	
ext_crypto_ses_3000::children	ext_crypto_ses_3000::children	NA	NA	
ext_crypto_ses_3000::expn	ext_crypto_ses_3000::expn	NA	NA	
ext_crypto_ses_3000::f_edu	ext_crypto_ses_3000::f_edu	NA	NA	
ext_crypto_ses_3000::f_occu	ext_crypto_ses_3000::f_occu	NA	NA	
ext_crypto_ses_3000::h_income	ext_crypto_ses_3000::h_income	NA	NA	
ext_crypto_ses_3000::hh_expen	ext_crypto_ses_3000::hh_expen	NA	NA	
ext_crypto_ses_3000::hh_rent	ext_crypto_ses_3000::hh_rent	NA	NA	
ext_crypto_ses_3000::how_b	ext_crypto_ses_3000::how_b	NA	NA	
ext_crypto_ses_3000::how_c	ext_crypto_ses_3000::how_c	NA	NA	
ext_crypto_ses_3000::how_d	ext_crypto_ses_3000::how_d	NA	NA	
ext_crypto_ses_3000::how_e	ext_crypto_ses_3000::how_e	NA	NA	
ext_crypto_ses_3000::income	ext_crypto_ses_3000::income	NA	NA	
ext_crypto_ses_3000::m_edu	ext_crypto_ses_3000::m_edu	NA	NA	
ext_crypto_ses_3000::m_income	ext_crypto_ses_3000::m_income	NA	NA	
ext_crypto_ses_3000::m_occu	ext_crypto_ses_3000::m_occu	NA	NA	
ext_crypto_ses_3000::member	ext_crypto_ses_3000::member	NA	NA	
ext_crypto_ses_3000::n_room	ext_crypto_ses_3000::n_room	NA	NA	
ext_crypto_ses_3000::o_expen	ext_crypto_ses_3000::o_expen	NA	NA	
ext_crypto_ses_3000::o_income	ext_crypto_ses_3000::o_income	NA	NA	
ext_crypto_ses_3000::ownhh	ext_crypto_ses_3000::ownhh	NA	NA	
ext_crypto_ses_3000::s_income	ext_crypto_ses_3000::s_income	NA	NA	
ext_crypto_ses_3000::sibling	ext_crypto_ses_3000::sibling	NA	NA	
ext_crypto_ses_3000::site	ext_crypto_ses_3000::site	NA	NA	
ext_crypto_ses_3000::sleep	ext_crypto_ses_3000::sleep	NA	NA	
ext_crypto_ses_3000::souce_c	ext_crypto_ses_3000::souce_c	NA	NA	
ext_crypto_ses_3000::source_b	ext_crypto_ses_3000::source_b	NA	NA	
ext_crypto_ses_3000::source_d	ext_crypto_ses_3000::source_d	NA	NA	
ext_crypto_ses_3000::source_e	ext_crypto_ses_3000::source_e	NA	NA	
ext_crypto_ses_3000::toilet_sh	ext_crypto_ses_3000::toilet_sh	NA	NA	
NA	NA	NA	NA	
NA	NA	NA	NA	
NA	NA	NA	NA	
NA	NA	NA	NA	
NA	NA	NA	NA	
NA	NA	NA	NA	
NA	NA	NA	NA	
NA	NA	NA	NA	
NA	NA	NA	NA	
NA	NA	NA	NA	
NA	NA	NA	NA	
NA	NA	NA	NA	
NA	NA	NA	NA	
NA	NA	NA	NA	
NA	NA	NA	NA	
NA	NA	NA	NA	
NA	NA	NA	NA	
NA	NA	NA	NA	
NA	NA	NA	NA	
NA	NA	NA	NA	
NA	NA	NA	NA	
NA	NA	NA	NA	
NA	NA	NA	NA	
NA	NA	NA	NA	
NA	NA	NA	NA	
NA	NA	NA	NA	
NA	NA	NA	NA	
NA	NA	NA	NA	
NA	NA	NA	NA	
NA	NA	NA	NA	
NA	NA	NA	NA	
NA	NA	NA	NA	
NA	NA	NA	NA	
NA	NA	NA	NA	
NA	NA	NA	NA	
NA	NA	NA	NA	
NA	NA	NA	NA	
NA	NA	NA	NA	
NA	NA	NA	NA	
NA	NA	NA	NA	
NA	NA	NA	NA	
NA	NA	NA	NA	
NA	NA	NA	NA	
NA	NA	NA	NA	
NA	NA	NA	NA	
NA	NA	NA	NA	
NA	NA	NA	NA	
NA	NA	NA	NA	
NA	NA	NA	NA	
NA	NA	NA	NA	
NA	NA	NA	NA	
NA	NA	NA	NA	
NA	NA	NA	NA	
NA	NA	NA	NA	
NA	NA	NA	NA	
NA	NA	NA	NA	
NA	NA	NA	NA	
NA	NA	NA	NA	
NA	NA	NA	NA	
NA	NA	NA	NA	
NA	NA	NA	NA	
NA	NA	NA	NA	
NA	NA	NA	NA	
NA	NA	NA	NA	
NA	NA	NA	NA	
NA	NA	NA	NA	
NA	NA	NA	NA	
NA	NA	NA	NA	
NA	NA	NA	NA	
NA	NA	NA	NA	
NA	NA	NA	NA	
NA	NA	NA	NA	
NA	NA	NA	NA	
NA	NA	NA	NA	
NA	NA	NA	NA	
NA	NA	NA	NA	
NA	NA	NA	NA	
NA	NA	NA	NA	
NA	NA	NA	NA	
NA	NA	NA	NA	
NA	NA	NA	NA	
NA	NA	NA	NA	
NA	NA	NA	NA	
NA	NA	NA	NA	
NA	NA	NA	NA	
NA	NA	NA	NA	
NA	NA	NA	NA	
NA	NA	NA	NA	
NA	NA	NA	NA	
NA	NA	NA	NA	
NA	NA	NA	NA	
NA	NA	NA	NA	
NA	NA	NA	NA	
NA	NA	NA	NA	
NA	NA	NA	NA	
NA	NA	NA	NA	
