Fraccion El Retiro	Unknown
Colonia 21 de marzo	Unknown
2a. Seccion de Izapa	Unknown
Iranian patient	Unknown
clinical isolate	Unknown
patient	Unknown
Kamrup	Unknown
Nadiad	Unknown
Kataragama	Unknown
Central America	Unknown
South Africa	Unknown
Ejido Consejo Agrario	Unknown
Finca San Antonio Nexapa	Unknown
field isolate	Unknown
clinical isolate from patient	Unknown
Central East Africa	Unknown
Panna	Unknown
blood from infected patient	blood
Rondonia	Unknown
from Iranian patient from Iran, Sistan and Bluchistan Province, Chahbahar District	Unknown
malaria patient in Chabahar, Sistan and Baluchistan, Iran	Unknown
placenta/DBL-gamma	placenta
hospital patient	Unknown
East Africa	Unknown
San Francisco Campamento	Unknown
blood blot of infected patient	blood
child	Unknown
human red blood cells	blood
human RBC	blood
Cd. Tapachula	Unknown
Canton San Cristobal	Unknown
Carrillo puerto Norte	Unknown
Ejido Carrillo puerto	Unknown
patient sample	Unknown
from Iranian patient from Iran, Sistan and Bluchistan Province, Iranshahr District	Unknown
from Afghani patient from Iran, Sistan and Bluchistan Province, Iranshahr District	Unknown
Patient sample	Unknown
Blood from a Japanese patient	blood
Southeast Asia	Unknown
blood of infected Aotus nancymai T1138	blood
Italian imported malaria case from Sri Lanka	Unknown
Finca Vega de los gatos	Unknown
Fraccion La Ceiba	Unknown
Ejido Cozalapa-Benito Juarez	Unknown
infected patient	Unknown
erythrocyte of Mus musculus	blood
West Africa	Unknown
South America	Unknown
Papua New Guinea	Unknown
Italian imported malaria case from Mozambique	Unknown
Pakistani patient	Unknown
human blood	blood
from patient with drug resistance	Unknown
cerebral malaria patient	Unknown
patient with mild symptoms	Unknown
Acrelandia	Unknown
Indochina	Unknown
child/DBL-gamma	Unknown
patient with severe symptoms	Unknown
blood from malaria patient	blood
traveller	Unknown
patient with sickle cell trait	Unknown
Canton Sn Nicolas Lagartero	Unknown
malaria patient blood	blood
malaria patient	Unknown
Chennai	Unknown
from Pakistani patient from Iran, Sistan and Bluchistan Province, Chahbahar District	Unknown
from Iranian patient from Iran, Sistan and Bluchistan Province, Iranshahr/Sarbaz District	Unknown
uncomplicated malaria patients without cerebral malaria	Unknown
asymptomatic patient	Unknown
member of the Jarawas tribe	Unknown
ex vivo generation from blood sample of patient	blood
Senegalese pregnant woman	Unknown
chimpanzee	Unknown
southeast Asia	Unknown
Senegalese non-pregnant adults	Unknown
Senegalese individual with cerebral malaria	Unknown
FMT-AM	Unknown
west Africa	Unknown
reclaimed wastewater	water
treated drinking water	water
wastewater	water
waste water	water
drinking water	water
surface water	water
open water reservoir	water
raw wastewater	water
dehydrated wastewater	water
surface river water	water
surface water sample after HCT-8 cell culture	water
water sample	water
storm water	water
raw water	water
river water	water
river water in the Kathmandu Valley, Nepal	water
diarrhoeic stool sample	feces
diarrhoeic fecal sample	feces
fecal sample from a cockatiel (19725-2)	feces
fecal sample from a cockatiel (17106-2)	feces
fecal sample from a cockatiel (933)	feces
fecal sample from a cockatiel (932)	feces
fecal sample from a cockatiel	feces
fecal sample from stomach	feces
feces from cattle with mixed infection of Cryptosporidium parvum and Cryptosporidium andersoni	feces
fecal sample from a peach-faced lovebird (20108-1)	feces
fecal sample from a peach-faced lovebird (20041-1)	feces
fecal sample from a peach-faced lovebird (131141-1)	feces
fecal sample from a peach-faced lovebird	feces
fecal sample from a peach-faced lovebird (14231-2)	feces
fecal sample from intestine	feces
duck feces	feces
fecal sample from a patient	feces
fecal sample from calf (#24)	feces
fecal sample from calf (#80)	feces
fecal sample from calf (#6)	feces
fecal sample from small intestine	feces
mouse enteral feces	feces
chicken feces	feces
sheep feces	feces
fecal isolate from river otter (Lontra canadensis)	feces
quail feces	feces
dairy cattle feces	feces
stool	feces
fecal sample from calf (#42)	feces
calf feces	feces
fecal sample from calf (#112)	feces
feces of cattle	feces
children with diarrhea	feces
diarrhetic human child	feces
stool sample	feces
fecal sample	feces
diarrheic child	feces
oocysts in the feces of the patient	feces
human feces	feces
fecal matter from human patient	feces
cattle feces	feces
fecal sample from calf (#58)	feces
child with diarrhea	feces
diarrhetic child	feces
Feces	feces
fecal material from a fox	feces
fecal sample from a veterinary clinic	feces
fecal sample from a ferret	feces
cat	Unknown
Japanese female	Unknown
pulmonary secretion	other source
patient infected with HIV	Unknown
Japanese grass snake	Unknown
Bos taurus	Unknown
chicken	Unknown
Chicken	Unknown
Le Treport (50deg04' N, 1deg22' E), La Manche sea	Unknown
HIV positive adult	Unknown
Yport (49deg44' N, 0deg19 'E), La Manche sea	Unknown
Eublepharis macularis captive in Czech Republic	Unknown
bovine calf	Unknown
banded mongoose	Unknown
finch	Unknown
Kuwaiti Children	Unknown
stool samples collected from malnourished children	feces
naturally infected calf	Unknown
children	Unknown
monkey	Unknown
Yport (49deg44' N, 0deg19' E), La Manche sea	Unknown
clam digestive gland	other source
Varanus exanthematicus imported to Czech Republic	Unknown
hemolymph	other source
Eumeces schneideri imported to Czech Republic	Unknown
human	Unknown
HIV infected adult	Unknown
dog	Unknown
gastric epithelium	other source
oocyst	Unknown
Rattus norvegicus	Unknown
isolated from Homo sapiens patient infected with HIV	Unknown
isolated from animal during laboratory passages; originally isolated from natural environmental infections	Unknown
Homo sapiens	Unknown
calf	Unknown
Human	Unknown
Malaysian aborigine	Unknown
farm	Unknown
goat	Unknown
HIV-infected patient	Unknown
stomach scraping	other source
cattle	Unknown
raccoon dog	Unknown
aged formalin-fixed stool from HIV-positive patient	feces
fecal sample from a pig (Farm A)	feces
fecal sample from a pig (Farm B)	feces
fecal sample from a pig (Farm C)	feces
fecal sample from a pig (Farm F)	feces
fecal sample from a pig (Farm E)	feces
female adult silkmoth	Unknown
male adult silkmoth	Unknown
infected child	Unknown
urinal sediment	urine
gills	Unknown
male	Unknown
fecal sample from a dog	feces
shoreline	Unknown
stool sample from immunocompetent human	feces
lens	Unknown
Salmo salar [Atlantic salmon]	Unknown
corneal scraping from patient with keratitis	other source
kidney	other source
stool sample of HIV+ patient	feces
HIV+ person	Unknown
patient stool sample #085	feces
pseudobranch	other source
liver	other source
patient stool sample #084	feces
heart	other source
spleen	other source
HIV-positive patient	Unknown
urine sample from immunocompetent human	urine
brain abscess of immunocompetent human	other source
squirrel monkey	Unknown
host collected from Atlantic salmon (salmo salar)	Unknown
hind gut	other source
Spanish bee infected with Nosema ceranae spores founded and isolated in Avignon, France	Unknown
Spanish bee infected with Nosema ceranae spores founded and isolated in Guadalajara, Spain	Unknown
nematode from compost pile	other source
patient stool sample #100	feces
fecal sample from a cat	feces
eggstrings	Unknown
female	Unknown
wild colony	Unknown
nematode from soil	other source
gills of salmon	other source
salivary glands	saliva
blood from Rattus sp.	blood
blood from sheep	blood
blood from the Brown Bear As5804	blood
blood from nestled seagull (Larus cachinnans)	blood
whole blood	blood
infected red fox spleen	other source
blood from 7-month old male calf	blood
blood from 7-year old male cow	blood
blood from 1-year old female sheep	blood
blood from 7-month old female lamb	blood
cervine blood	blood
field blood sample cattle nr. 11M	blood
blood from sheep experimentally infected with Haemaphysalis qinghaiensis	tick
Rhipicephalus annulatus	tick
blood from Apodemus speciosus Hatahiyodori	blood
blood from spleen	blood
Babesia gibsoni-infected dog	Unknown
female tick	tick
infected dog blood	blood
infected host blood	blood
blood from naturally infected dog	blood
unfed adult tick collected in 2003	tick
a blood of field rodent	blood
larvae with M. glareolus	Unknown
blood (erythrocyte asexual stage)	blood
blood of trapped red-backed vole (Clethrionomys rutilus)	blood
lymph node of infected cattle	other source
blood from sheep experimentally infected with the tick species Rhipicephalus evertsi	tick
Addo Elephant Game Park	Unknown
field blood sample cattle nr. 34KH	blood
infected cow blood	blood
host blood	blood
infected horse blood	blood
Dermacentor reticulatus removed from a dog	tick
reindeer blood	blood
naturally acquired Lancaster	Unknown
blood from animal with a subclinical infection	blood
infected goat blood	blood
infected seagull blood	blood
larvae with M. rufocanus	Unknown
Ixodes ricinus	tick
Ixodes persulcatus	tick
blood from brown bear 1021	blood
blood from raccoon SAP#091	blood
canine blood	blood
blood sample from cow with teileriosis	blood
field blood sample cattle nr. 48KH	blood
blood from 9-month old female sheep	blood
field blood sample cattle nr. 348	blood
field blood sample cattle nr. 90N	blood
field blood sample cattle nr. 60M	blood
infected sheep blood	blood
Hyalomma impeltatum	tick
cultured Babesia gibsoni at Hokkaido University	Unknown
blood from Apodemus speciosus Aw3	blood
blood from raccoons MA#230, SAP#080 and SAP#120	blood
blood from dog 5332	blood
spleen and liver	other source
blood from a dog	blood
larvae with M. rutilus	Unknown
Microtus agrestis	Unknown
fallow deer	Unknown
bighorn sheep	Unknown
field blood sample cattle nr. 103	blood
Shambat	Unknown
blood from sheep experimentally infected with the tick species Haemaphysalis qinghaiensis	tick
blood from 5-year old female cow	blood
Spain: Galicia	Unknown
blood from 7-year old female cow	blood
blood from Myodes rufocanus AK2348	blood
canine	Unknown
elk blood	blood
blood from raccoon MA#361	blood
collected on Oryx gazella gazella	Unknown
pre-scapular lymph node	other source
blood from goat No. 4	blood
blood from goat No. 6	blood
field blood sample cattle nr. 4KH	blood
Hluhluwe-iMfolozi Game Park	Unknown
polyclonal cell line of schizont infected bovine cells	other source
cat with fatal infection	Unknown
cat with a fatal infection	Unknown
field blood sample cattle nr. 55M	blood
Hyalomma dromedarii	tick
blood from 6-year old female cow	blood
blood from cattle	blood
blood from Apodemus speciosus Tsukiyo2	blood
red blood cell culture	blood
dog blood	blood
infected calf blood	blood
blood of cat that survived clinical cytauxzoonosis	blood
field blood sample cattle nr. 16T	blood
Hantoub	Unknown
blood from 4-month old female goat	blood
blood from 1-year old male cow	blood
field blood sample cattle nr. 25M	blood
blood from a hospitalized woman	blood
Bovine erythrocyte infected with T.orientalis	blood
cell line of schizont infected bovine cells	other source
blood from Apodemus speciosus Takanosu16	blood
red blood cells	blood
blood donor	blood
blood of dog with clinical signs of babesiosis	blood
patient blood	blood
blood from raccoon SAP#131	blood
reindeer	Unknown
infected buffalo	Unknown
blood stabilate from goat No. 4	blood
field blood sample cattle nr. 81	blood
Atbara	Unknown
blood from 3-year old female goat	blood
field blood sample cattle nr. 34M	blood
blood from 18-year old female sheep	blood
Bovine	Unknown
Clethrionomys rufocanus	Unknown
blood from dog 5319	blood
Ixodes ricinus eggs and larva	tick
rodent blood, field rodent(Rattus coxinga)	blood
blood from Brown Bear As5804	blood
naturally infected dog with clinical babesiosis	Unknown
blood from animal with acute, fatal babesiosis	blood
cat blood sample	blood
caribou blood	blood
blood of Japanese black bear	blood
bovine blood	blood
ovine blood	blood
cattle blood	blood
blood of trapped tundra vole (Microtus oeconomus)	blood
blood stabilate from goat No. 6	blood
cell line of schizont infected ovine cells	other source
WTD blood	blood
Rhipicephalus bursa	tick
field blood sample cattle nr. 1109	blood
Hyalomma marginatum	tick
body	Unknown
Holstein cattle	Unknown
EDTA-anticoagulated whole blood	blood
giraffe blood	blood
multigravid	other source
secundigravid	other source
blood sample	blood
primigravid	other source
Fecal sample	feces
ferret	Unknown
brain with cysts	brain
blood of kidney transplant recipient patients	blood
aqueous aspirate collected from a patient with clinically diagnosed toxoplasma retinochoroiditis	other source
brain of Rattus norvegicus (Wild rat)	brain
brain of Domestic Chicken (Gallus gallus domesticus)	brain
muscles of infected intermediate host	muscle
whole blood of a naturally infected adult male	blood
murine fibroblast cell line L929	other source
murine tissue	other source
lymph node tissue	other source
feces of Grus japonensis	feces
lung	other source
heart muscle	muscle
chicken brain	brain
myocardium of Japanese Sika deer	other source
aborted fetus	Unknown
male heart tissue	other source
T. gondii isolated from a dead toucan from Costa Rican National Zoo	Unknown
brain of Sparrow (Passer domesticus)	brain
skeletal muscle	muscle
erythrocyte from blood	blood
feces of Canis familiaris fed body tissues of infected Cavia porcellus	feces
muscle cyst	muscle
female muscle tissue	muscle
in vitro culture	other source
oocysts	other source
crane No.7	Unknown
crane No.1	Unknown
Crane No.1	Unknown
Changjiang fishpond	Unknown
intestinal tissue	other source
buffy coat	Unknown
lymph node	other source
tongue	other source
Blood of patients with end-stage renal disease (ESRD) undergoing haemodialysis	blood
infected big brown bat kidney	other source
experimentaly infected intermediate hosts (laboratory mice)	Unknown
white-tailed deer no. 53	Unknown
medulla oblongata of canine	brain
chicken faeces	feces
human fecal sample	feces
blood-drop	blood
peripheral blood leukocyte	blood
vitreous aspirate	other source
CSF	brain
California sea otter	Unknown
brain of Rattus ruttus (Wild rat)	brain
soil	soil
host brain	brain
muscle of Domestic Chicken (Gallus gallus domesticus)	muscle
paraffin embedded formalin fixed muscle tissue of host	muscle
tail-tip	Unknown
naturally infected host tissue	Unknown
eosophagous	other source
Dr. Hilda Pena	Unknown
DNA samples provided by Dr. David Sibley at Washington University School of Medicine in St. Louis, MO	Unknown
DNA samples provided by Drs. Marie-laure Darde and Daniel Ajzenberg at the University of Limoges in France.	Unknown
John Ellis	Unknown
fecal samples from a gray squirrel, Sciurus carolinensis	feces
brain of Starling (Sturnus vulgaris)	brain
intestine	other source
transudate from the thoracal body cavity	other source
aborted sheep fetal brain	brain
brain of infected cow	brain
Crane No.7	Unknown
dairy cattle farm	Unknown
blood from raccoons MA#347 and SAP#110	blood
naturally-infected buffalo	Unknown
liver of aborted fetus	other source
dog feces	feces
brain of Pigeon (Columba livia)	brain
Muscle of Sparrow (Passer domesticus)	muscle
white-tailed deer no. 36	Unknown
isolated from feces of a dog (Canis familiaris)	feces
blood from raccoon NP#023	blood
gall bladder	other source
chicken in low performance farm	Unknown
fecal sample from a Japanese patient	feces
oesophagus	other source
diaphragm	other source
experimentaly infected intermediate hosts (Meriones)	Unknown
esophageal cyst	other source
tissue cysts	other source
DNA sample provided by Drs. Marie-laure Darde and Daniel Ajzenberg at the University of Limoges in France.	Unknown
DNA sample provided by Dr. David Sibley at Washington University School of Medicine in St. Louis, MO	Unknown
Toque monkey	Unknown
40 year-pld male patient with ALA (amebic liver abscess)	other source
fecal sample from the patient (#7)	feces
feces of De Brazza's guenon	feces
liver tissue from a toucan that died due to amebic infection	other source
floating biofilm in hot spring water; sampling site:C2	water
solid-liquid interface biofilm in hot spring water; sampling site:F25	water
floating biofilm in hot spring water; sampling site:F25	water
solid-liquid interface biofilm in hot spring water; sampling site:F3	water
floating biofilm in hot spring water; sampling site:C7	water
floating biofilm in hot spring water, sampling site C21	water
solid-liquid interface biofilm in hot spring water, sampling site C1	water
dust sample collected from air-handler of centralized air-conditioner	other source
biofilm	other source
dust sample collected from room air-conditioner	other source
contact lenses	other source
Norwegian tap inner surfaces	other source
salt cave scrape	other source
dust of air conditioner filter	other source
dialysis unit water	water
hot springs	water
CSF from patient with granulomatous amoebic encephalitis	other source
water from rice field	water
amoebic liver abscess	other source
paraffin-embedded intestine	other source
liver abscess fluid of an amebic liver abscess patient	other source
fixed biofilms in hot spring water	water
patients with ocular infections admitted to the hospital	other source
solid-liquid interface biofilm in hot spring water, sampling site E5	water
soft water	water
left corneal scrape	other source
left contact lens	other source
box contact lens	other source
corneal scrape, right contact lens, left contact lens	other source
right contact lens, left contact lens	other source
right contact lens	other source
keratitis lesion	other source
solid-liquid interface biofilm in hot spring water, sampling site A8	water
axenic cultures established at the L. V. Prasad Eye Institute	other source
patient presenting pseudodendritiform epitheliopathy and radial keratoneuritis	other source
patient presenting annular stromal infiltrate	other source
air conditioner scrape	other source
air conditioner water	water
dental unit scrape	other source
forest soil	soil
cysts from host faeces	feces
stool of amobiasis patients	feces
liver abcess pus of an amebic liver abscess patient	other source
stool of an amebic liver abscess patient	feces
feces of Mongolian gerbil	feces
corneal scraping	other source
3-phase biofilm	other source
keratitis patient	other source
non-contact lens related keratitis patient's environment	other source
corneal scrape	other source
floating biofilm in hot spring water; sampling site:F32	water
solid-liquid interface biofilm in hot spring water; sampling site:F6	water
solid-liquid interface biofilm in hot spring water; sampling site:F14	water
floating biofilm in hot spring water, sampling site C5	water
solid-liquid interface biofilm in hot spring water, sampling site F17	water
swabs from contact lens case of the patient infected with Acanthamoeba isolate AC11-1	other source
water reservior sediment	water
corneal scrape, needle, right contact lens	other source
aquarium water sample	water
beach sand	other source
tapwater	water
contact lenses and contact lenses case	other source
corneal epithelium of Iranian patient	other source
swabs from contact lens case of the patient infected with Acanthamoeba isolate AC6	other source
swabs from contact lens case of the patient infected with Acanthamoeba isolate AC29	other source
black stain on cave sediment	other source
clinical sample	Unknown
fountain	water
swimming pool scrape	water
host faeces	feces
purified cysts from faeces	feces
contact lens sample from non-keratitis patient	other source
floating biofilm in hot spring water; sampling site:C4	water
solid-liquid interface biofilm in hot spring water; sampling site:F20	water
solid-liquid interface biofilm in hot spring water, sampling site C12	water
floating biofilm in hot spring water, sampling site C7	water
solid-liquid interface biofilm in hot spring water, sampling site F11	water
contact lens case sample from non-keratitis patient	other source
keratitis patients having no history of contact-lens wear	other source
lake	water
skin biopsy	skin
river	water
patient with keratitis coinfection	other source
patient presenting redness, photophobia and elevated epithelia lines	other source
contact lens of female patient	other source
infected eye	other source
gill tissue	other source
swimming pool	water
55 year-old male patient with PLA (pyogenic liver abscess)	other source
saliva from amoebic liver abscess patient	saliva
rhesus monkey	other source
Surface water	water
hospital water	water
solid-liquid interface biofilm in hot spring water; sampling site:F13	water
solid-liquid interface biofilm in hot spring water; sampling site:F17	water
floating biofilm in hot spring water, sampling site A9	water
floating biofilm in hot spring water, sampling site C18	water
yeast culture	other source
corneal scraping of keratitis patient	other source
lens case B	other source
corneal scraping from a keratitis patient wearing contacts	other source
solid-liquid interface biofilm in hot spring water, sampling site C17	water
swimming pool water sample	water
sewage canal water sample	water
swabs from contact lens case of the patient infected with Acanthamoeba isolate AC15	other source
floating biofilms in hot spring water	water
dust	other source
thymus	other source
AIDS patient	other source
salt cave salt water	water
a rice field of the Istituto Sperimentale della Risicoltura	other source
purified cysts from feces	feces
cutaneous amoebiasis	other source
sewage	water
Macaca mulatta	other source
feces of Gorilla gorilla	feces
tap water	water
corneal scrapings from a patient with keratitis	other source
solid-liquid interface biofilm in hot spring water; sampling site:F21	water
personal hot tub	water
solid-liquid interface biofilm in hot spring water; sampling site:E3	water
solid-liquid interface biofilm in hot spring water; sampling site:F23	water
conjuntival swab	other source
amniotic membrane	other source
hard water	water
corneal scrape, left contact lens, right contact lens	other source
left corneal lens	other source
left contact lens, right contact lens	other source
corneal scrape, left contact lens	other source
dust sample collected from vents of centralized air-conditioner	other source
floating biofilm in hot spring water, sampling site C3	water
natural populations	Unknown
corneal button	other source
corneal biopsy	other source
cave sediment	other source
drinking water distribution system pipe biofilm	water
purified cysts from host faeces	feces
stool from patient with non-dysenteric amebic colitis, maintained in axenic culture containing patient's original intestinal flora	feces
cynomolgus monkey	other source
contact lens case	other source
cornea	other source
floating biofilm in hot spring water; sampling site:A11	water
public hot tub	water
floating biofilm in hot spring water; sampling site:C16	water
hot spring water	water
floating biofilm in hot spring water, sampling site B9	water
raw surface water	water
Homo sapiens eye	other source
corneal scrape, right contact lens	other source
solid-liquid interface biofilm in hot spring water, sampling site F26	water
flowerpot soil	soil
axenic cultures established at the microbiology lab of LV Prasad Eye Institute, Hyderabad, India	other source
contact lenses case	other source
lake water	water
marsh sediment	other source
tap hot water	water
stool sample from the mentally retarded patient	feces
39 year-old female patient with ALA (amebic liver abscess)	other source
primary culture	Unknown
57 year-old female patient with MLA (mixed liver abscess; amebic and pyogenic)	other source
fecal sample from the patient (#10)	feces
human liver	other source
non-contact lens related keratitis patient	other source
solid-liquid interface biofilm in hot spring water; sampling site:C2	water
floating biofilm in hot spring water; sampling site:C31	water
floating biofilm in hot spring water, sampling site C17	water
human keratitis infection	other source
floating biofilm in hot spring water, sampling site B18	water
contact lens	other source
sediment of a water reservoir	water
dust sample on vents of centralized air-conditioner	other source
soil sample	soil
solid-liquid interface biofilm in hot spring water, sampling site A10	water
solid-liquid interface biofilm in hot spring water, sampling site C4	water
floating biofilm in hot spring water, sampling site A32	water
floating biofilm in hot spring water, sampling site A12	water
biofilm of recirculating aquaculture system	water
artificial lake	water
swimming pool water	water
Feces of monkeys	feces
Feces of calves	feces
Feces of a calf	feces
Feces of cats	feces
Feces of a dog	feces
Feces of dogs	feces
guano	feces
raw sewage of a wastewater treatment plant	water
hospital wastewater in the Kathmandu Valley, Nepal	water
fecal sample from a barred parakeet	feces
fecal sample from a budgerigar	feces
faeces	feces
muscle abcess	muscle
sewage-polluted river	water
stool sample from the mentally retarded patient 202	feces
Thymallus thymallus	Unknown
farmed Salmo salar	Unknown
wild Salvelinus alpinus	Unknown
farmed Salvelinus alpinus	Unknown
Africa	Unknown
Korea	Unknown
cat feces	feces
secondary-treated sewage of a wastewater treatment plant	water
Giardia duodenalis trophozoite QIMR stock BRIS/91/HEPU/1279	Unknown
Giardia duodenalis trophozoite QIMR stock BRIS/87/HEPU/713	Unknown
treated wastewater	water
wastewater treatment plant	water
fecal sample from a human	feces
fecal	feces
scat	feces
cyst	other source
gut region of pebrine infected tropical tasar silkworm	other source
bronchoalveolar lavage fluid from patient with disseminated microsporidiosis	other source
corneal tissue	other source
stool specimen	feces
tracheal biopsy from a patient with hoarseness	other source
epithelial cells of the gut and peritoneal cavity	other source
epithelial cell and peritoneal cavity	other source
epithelial cells and organs in peritoneal cavity	other source
archaeological material (sediment) from well/cesspit from 18th century	other source
archaeological material (sediment) from well from the 18th/19th century	other source
Phlebotomus group Caucasicus	Unknown
Phlebotomus papatasi	Unknown
Phlebotomus sergenti	Unknown
bone marrow	bone
Teresina_PI	Unknown
Echimys dasythrix	Unknown
blood (Buffy coat layer)	blood
bone marrow of a 1.5 years old child	bone
epitelial cells from conjuntivas	other source
skin lesion	skin
PCR-derived sequence from cultured trypanosomes	other source
PCR-derived sequence from blood trypanosomes	blood
Center Laboratory of Union Hospital of Beijing in China	Unknown
isolated in 2003 from a camel and passaged once in mice	Unknown
isolated in 1968 from a camel and passaged 140 times in mice	Unknown
scar	Unknown
Choloepus didactylus	Unknown
Choloepus hoffmanni	Unknown
Horse Blood	blood
Jarrah Forest (Dwellingup, WA)	Unknown
Sciurus granatensis	Unknown
axenic culture	other source
fly midgut	other source
host skin	skin
human skin leishmaniasis lesions	skin
Culture of the blood from a ball python imported from Ghana	blood
insect	Unknown
Campo Grande_MS	Unknown
Lutzomyia hartmanni	Unknown
avian blood	blood
wild avian blood	blood
biopsy	Unknown
cutaneous leishmaniasis patient with recidivan form	other source
cutaneous lesion	other source
moose blood	blood
pool of ten sandflies	Unknown
midgut	other source
oral	Unknown
Dicerorhinus sumatrensis (Sumatran rhinoceros)	Unknown
Peripheral blood of patients with Indeterminate phase of Chagas disease	blood
Peripheral blood of patients with Megacolon Chagas disease	blood
Peripheral blood of patients with Cardiopathy Chagas disease	blood
The peripheral blood of SCID mice infected experimentally	blood
The peripheral blood of red-handed tamarins	blood
bone marrow aspirate	bone
ulcers of animal infected by disseminated Leishmaniasis	other source
lesion from cutaneous leishmaniasis patient	other source
Saimiri scireus	Unknown
Malpighian tubes	other source
Skin lesion of human cutaneous leishmaniasis	skin
lesion	other source
Visceral leishmaniasis + post kala azar leishmaniasis	Unknown
bone marrow smear	bone
bone marroww from 1.5 year old child	bone
patient with visceral leishmaniasis	Unknown
bone marrow of Canine	bone
Bradypus sp.	Unknown
field isolate from patient	Unknown
fly proboscis	other source
sand fly midgut	other source
sika deer (Cervus nippon yesoensis)	Unknown
stomach contents	other source
Blood of experimentally infected jirds	blood
cutaneous leishmaniasis patient	other source
midgut/hindgut	other source
midgut or hingut of heteropteran bug	other source
Visceral leishmaniasis	Unknown
blood of an adult raven	blood
cutaneous biopsy	other source
cutaneous membrane from HIV-infected patient receiving treatment for leishmaniasis	other source
Adamaoua plateau	Unknown
Post kala azar dermal leishmaniasis	other source
Rhodnius prolixus	Unknown
lymph node aspirate	other source
midgut of Haemaphysalis hystricis	tick
rat bloodstream	blood
6 feet deep loam soil	soil
River	water
Xinlicheng lake water	water
aerosol	other source
air condition water	water
apple orchard soil	soil
asparagus straw compost	soil
boring water	water
canal	water
canal water	water
canal water sample	water
compost	soil
contact lens; contact lens case	other source
contact-lens case of keratitis patient	other source
cooling water	water
corneal biopsy from keratitis patient	other source
corneal scraping from keratitis patient	other source
dead-end pipeline	Unknown
decomposed soil	soil
eye	other source
farm soil	soil
fertile soil	soil
floating biofilm in hot spring water, sampling site A24	water
floating biofilm in hot spring water, sampling site A27	water
floating biofilm in hot spring water, sampling site B14	water
floating biofilm in hot spring water, sampling site B21	water
floating biofilm in hot spring water, sampling site B22	water
floating biofilm in hot spring water, sampling site B27	water
floating biofilm in hot spring water, sampling site B28	water
floating biofilm in hot spring water, sampling site B31	water
floating biofilm in hot spring water, sampling site C16	water
floating biofilm in hot spring water, sampling site C24	water
floating biofilm in hot spring water, sampling site C25	water
floating biofilm in hot spring water, sampling site C26	water
floating biofilm in hot spring water, sampling site D3	water
floating biofilm in hot spring water, sampling site D9	water
floating biofilm in hot spring water, sampling site E10	water
floating biofilm in hot spring water, sampling site E11	water
floating biofilm in hot spring water, sampling site E9	water
floating biofilm in hot spring water, sampling site F13	water
floating biofilm in hot spring water, sampling site F14	water
floating biofilm in hot spring water, sampling site F17	water
floating biofilm in hot spring water, sampling site F18	water
floating biofilm in hot spring water, sampling site F22	water
floating biofilm in hot spring water, sampling site F23	water
floating biofilm in hot spring water, sampling site F26	water
floating biofilm in hot spring water, sampling site F28	water
floating biofilm in hot spring water, sampling site F29	water
floating biofilm in hot spring water, sampling site F3	water
floating biofilm in hot spring water, sampling site F35	water
floating biofilm in hot spring water, sampling site F5	water
floating biofilm in hot spring water, sampling site F7	water
floating biofilm in hot spring water, sampling site F8	water
fresh water	water
freshwater aquarium	water
garden pond	water
hospital drinking water network	water
hospital ward	other source
hot spring	water
household dust	other source
human male cerebrospinal fluid	brain
keratitis	other source
kidneys	other source
lizard	Unknown
male, cerebro-spinal fluid	brain
non-embryogenic callus	other source
patient with ocular infections admitted to Kanazawa university hospital	other source
pond	water
pool water	water
raw domestic water	water
sewage water	water
skin lesions	skin
sludge	other source
solid-liquid interface biofilm in hot spring water, sampling site A18	water
solid-liquid interface biofilm in hot spring water, sampling site D3	water
solid-liquid interface biofilm in hot spring water, sampling site F14	water
spined water from sludge	water
spring water	water
stagnant water	water
stream water	water
stromatolitic stalagmite in Karst cave	other source
surface fertile soil	soil
surface sand soil	soil
swamp	water
swamp water	water
trembling aspen rhizosphere under ambient CO2 conditions	soil
water boring sample	water
water from air conditioning unit	water
water reservoir	water
water with sediment	water
Acrocephalus agricola	Unknown
Brazilian Amazon	Unknown
Caribbean Islands	Unknown
Caribbean island	Unknown
Chasiempis sandwichensis	Unknown
Culex bitaeniorhynchus	Unknown
Culex inatomii	Unknown
Culex tritaeniorhynchus	Unknown
Dendroica caerulescens	Unknown
Hemignathus virens	Unknown
Taiwan	Unknown
Vesteria coccinea	Unknown
Western Brazilian Amazon	Unknown
bird blood	blood
blood from Agelaius phoeniceus	blood
blood from Alethe diademata	blood
blood from Andropadus latirostris and Phyllastrephus laterinus	blood
blood from Baelophus bicolor	blood
blood from Cinclocerthia ruficauda	blood
blood from Coereba flaveola	blood
blood from Helmitheros vermivorus and Dendroica magnolia	blood
blood from Loxigilla noctis	blood
blood from Nectarinia olivacea	blood
blood from Passer domensticus	blood
blood from Passerina cyanea	blood
blood from Thryothorus ludovicianus	blood
blood from Tiaris bicolor	blood
blood from Turdus migratorius	blood
blood from Vireo altiloquus	blood
blood from Vireo griseus	blood
blood from Zonotrichia leucophrys	blood
blood from a malaria patient	blood
blood of Acrocephalus arundinaceus	blood
blood of Acrocephalus orientalis	blood
blood of Agama agama	blood
blood of Ameiva ameiva	blood
blood of Anolis oculatus	blood
blood of Atheruri africanus	blood
blood of Gallus gallus	blood
blood of Larosterna inca	blood
blood of Ninox scutulata	blood
blood of Norops cupreus	blood
blood of Quiscalus quiscula	blood
blood of Sceloporus jarrovi	blood
blood of Sceloporus mexicanum	blood
blood of Turdus migratorius	blood
blood of Zeneida macroura	blood
blood smear	blood
blood, liver, and spleen	other source
chimpanzee 2	Unknown
extracted DNA from blood-fed Aedes esoensis	other source
extracted DNA from blood-fed Cx. pipiens	other source
extracted DNA from unfed Culex nigropunctatus	other source
extracted DNA from unfed Culex pipiens group	other source
fecal matter	feces
human whole blood	blood
isolated from mosquito whole body	Unknown
mosquito head-thorax portion 8078 (NHM)	Unknown
mosquito head-thorax portion 8084 (NHM)	Unknown
mosquito head-thorax portion 8089 (NHM)	Unknown
mosquito head-thorax portion 8097 (NHM)	Unknown
mosquito head-thorax portion 8103 (NHM)	Unknown
mosquito head-thorax portion 8113 (NHM)	Unknown
mosquito head-thorax portion 8114 (NHM)	Unknown
mosquito head-thorax portion 8119 (NHM)	Unknown
mosquito head-thorax portion 8124 (NHM)	Unknown
mosquito head-thorax portion 8126 (NHM)	Unknown
mosquito head-thorax portion 8127 (NHM)	Unknown
mosquito head-thorax portion 8129 (NHM)	Unknown
patient 1	Unknown
patient 2	Unknown
splectomized chimpanzee Oscar	Unknown
whole body	Unknown
wild macaques	Unknown
Coccivac B vaccine	Unknown
blood cell of female dairy cow	blood
blood cells of a dairy cow	blood
blood cells of female dairy cow	blood
calf muscle	muscle
cerebrospinal fluid	brain
cyst in heart muscle	muscle
cyst in loin muscle	muscle
diaphragmatic muscle	muscle
faecal sample	feces
fecal material from experimentaly infeced dingo	feces
feces from domestic rabbits	feces
free-range chicken	Unknown
high performance farms	Unknown
host muscle tissue	muscle
lateral digital extensor carpi	bone
low performance farms	Unknown
naturally infected host	Unknown
rhizosphere of sunflower plants collected from nitrogen fertilized soil	soil
single cyst in minced meat	Unknown
trembling aspen rhizosphere under elevated CO2 conditions	soil
triceps femoris	muscle
Cattle. AC40	Unknown
Cattle. AC5	Unknown
Cattle. AC56	Unknown
Cattle. AC57	Unknown
Cattle. AC72	Unknown
Cattle. AC73	Unknown
Cattle. AC74	Unknown
Cattle. BH110	Unknown
Cattle. BH133	Unknown
Cattle. BH135	Unknown
Cattle. BH136	Unknown
Cattle. BH14	Unknown
Cattle. BH16	Unknown
Cattle. BH18	Unknown
Cattle. BH20	Unknown
Cattle. BH52	Unknown
Cattle. BH66	Unknown
Cattle. BH72	Unknown
Cattle. BH8	Unknown
Cattle. BH89	Unknown
Cattle. CR192	Unknown
Cattle. CR198	Unknown
Cattle. CR307	Unknown
Cattle. CR352	Unknown
Cattle. CR386	Unknown
EDTA-blood of dog with clinical signs of babesiosis	blood
agriculture waste compost	soil
blood from animal with clinical babesiosis	blood
blood from mink AS4904	blood
blood of a female	blood
blood of captive brown bear	blood
blood sample from sheep	blood
clinical case	Unknown
clinically infected host	Unknown
engorged larva collected from Apodemus flavicollis	other source
engorged larva collected from Myodes glareolus	other source
field rodent spleen	other source
infected blood	blood
infected cat blood	blood
infected fox liver	other source
infected spleen	other source
questing adult female	Unknown
questing adult male	Unknown
questing nymph	Unknown
skin sample	skin
tick feeding on roe deer	tick
tissue	other source
vaccine cell culture	other source
woodrat	Unknown
asymtomatic child with microsporidiosis	Unknown
bee hives	other source
deforest	Unknown
forest	Unknown
industrial area	Unknown
metalworking fluid system	Unknown
mountain	Unknown
Asia	Unknown
Camden Diary Farm	Unknown
Chao Phraya River water	water
Dabie Duze Lake (Lubczyna)	water
Glebokie Lake (Szczecin)	water
Rusalka Lake (Szczecin)	water
acute lymphoid leukaemia child	Unknown
adult Bos taurus	Unknown
bird feces	feces
calf fecal sample	feces
child with acute lymphoid leukaemia	Unknown
deer fecal sample	feces
diarrehic child	Unknown
environmental water sample	water
farm manure pit	other source
feces and intestinal mucosa	feces
feces from Qinchuan cattle	feces
feces from dairy cattle	feces
feces from diarrehic child	feces
feces from pre-weaned dairy cattle	feces
feces of a buffalo calf	feces
forest soil from the long-term soil productivity (LTSP) site Skulow Lake	soil
gills and digestive glands	other source
goose fecal sample	feces
human stool	feces
raccoon fecal sample	feces
sheep fecal sample	feces
stomach of amphibian pet animal import from Malaysia	other source
stool from human	feces
stool of infected patient	feces
surface water source	water
tissue sample	other source
unknown fecal sample	feces
wastewater treatment plant effluent	water
Dabie Male Lake (Szczecin)	water
Weltynskie Lake (Weltyn)	water
effluent of a wastewater treatment plant	water
farmed rainbow trout 2	other source
fecal sample from a cattle	feces
feces from diarrhoeic goat kids	feces
feces of calf	feces
in vitro	feces
influent of a wastewater treatment plant	water
rainbow trout 1	other source
recreational lake water	water
sewage sludge	other source
aqueous humour	other source
corneal surface tissue	other source
feces in water	feces
fish muscle	other source
high altitude soil	soil
human patient with ocular infection	Unknown
intensively managed grassland soil	soil
keratitis infection	Unknown
lesion cutaneous	Unknown
lesion mucosa	Unknown
liver aspirates of an amoebic liver abscess patient	Unknown
mesh in plughole	Unknown
nasal lesion	Unknown
nasal mucosa	Unknown
pasture soil	soil
public bath	water
reservoirs	water
scraped saliva of HIV infected patient	saliva
scraped saliva of human immunocompetent	saliva
anglerfish	Unknown
feces from Lacerta schreiberi	feces
gut content	other source
feces of exotic birds	feces
feces of pigeon	feces
feces of pigeon and exotic birds	feces
Bearded vulture 9361	Unknown
Budgerigar 367	Unknown
Canary bird 18087	Unknown
Chalcophaps indica	Unknown
Eurasian collared-dove 11785	Unknown
Eurasian collared-dove 15937	Unknown
Feces of Sus scrofa f. domestica	feces
Geopelia humeralis	Unknown
Geopelia striata	Unknown
Phaps chalcoptera	Unknown
Racing pigeon 231	Unknown
Racing pigeon 7895	Unknown
Racing pigeon 8855	Unknown
Spanish woman	Unknown
beak	Unknown
bronchi	other source
bull semen	other source
formalin fixed tissues samples from avian necropsy cases	other source
host caecum	other source
host crop (oesophagus)	other source
intestinal content	other source
oral cavity	other source
oral cavity of Canis familiaris	other source
pied imperial-pigeon	Unknown
pleural fluid	other source
turkey faeces	feces
vaginal specimen	other source
vaginal swab	other source
Chabahar District	Unknown
Chinese-malaria-patient-SHZ from West Africa	Unknown
MRA-350G from ATCC	Unknown
MRA-352G from ATCC	Unknown
MRA-486F from ATCC	Unknown
MRA-488F from ATCC	Unknown
blood day 0	blood
blood day 14	blood
blood day 21	blood
blood day 28	blood
blood day 35	blood
blood day 42	blood
blood day 7	blood
blood from patient in northwest Thailand	blood
finger prick blood sample	blood
infected human liver cell line (HepG2)	other source
malaria patient ZBP	Unknown
malarial patient	Unknown
malarial patient blood	blood
Alpinia flowers	other source
Brugmansia flowers	other source
Citrus fruit	other source
Hibiscus flowers	other source
Ipomoea flowers	other source
Kala-azar patient	Unknown
Morinda fruit	other source
North America	Unknown
North Gondar	Unknown
Opuntia fruit	Unknown
Pandanus fruit	other source
PostKala-azar Dermal Leishmaniasis skin isolate, cultured parasite	skin
Russula mushroom	other source
Stenocereus gummosus (agria cactus)	other source
Terminalia fruit	other source
biopsy skin of human patient (Cutaneous Leishmaniasis ulcer)	skin
blood from Thai man co-infected with Leishmania sp. 'siamensis' and HIV	blood
blood from from Burmese man coinfected with Leishmania sp. 'siamensis' and HIV	blood
blood from symptomatic Burmese man	blood
blood from visceral leishmaniasis in Thai man	blood
blood of cattle	blood
blood spotted on filter paper	blood
bone marrow biological material spotted on filter paper	bone
bone marrow from Thai man co-infected with Leishmania sp. 'siamensis' and HIV	bone
bone marrow from visceral leishmaniasis	bone
bone marrow from visceral leishmaniasis in Thai man	bone
buffy coat from Thai man co-infected with Leishmania sp. 'siamensis' and HIV	other source
buffy coat from asymptomatic Burmese woman	other source
buffy coat from from Burmese man coinfected with Leishmania sp. 'siamensis' and HIV	other source
buffy coat from symptomatic Burmese man	other source
buffy coat from visceral leishmaniasis in Thai man	other source
culture	other source
cultured parasite	other source
cutaneous isolate, culture	skin
cutaneous isolate, cultured parasite	skin
gorilla stool	feces
host spleen	other source
kala-azar patient	Unknown
lymph node aspirate spotted on filter paper	other source
midgut or hindgut	other source
mucocutaneous isolate, cultured parasite	skin
patient with cutaneous leishmaniasis	skin
saliva from Burmese man coinfected with Leishmania sp. 'siamensis' and HIV	saliva
saliva from Thai man co-infected with Leishmania sp. 'siamensis' and HIV	saliva
saliva from asymptomatic Burmese woman	saliva
saliva from symptomatic Burmese man	saliva
saliva from visceral leishmaniasis in Thai man	saliva
sandfly midgut	other source
skin biopsy of sodium stibogluconate-treated PKDL patient	skin
skin from Thai man coinfected with Leishmania sp. 'siamensis' and HIV	skin
skin nodule	skin
skin nodules	skin
smear from cutaneous leishmaniasis	skin
smear from cutaneous leishmaniasis and bone marrow from visceral leishmaniasis	other source
smear from cutaneous leishmaniasis patient	skin
tissue biopsy	other source
tissue biopsy from Thai man co-infected with Leishmania sp. 'siamensis' and HIV	other source
tissue from Burmese man coinfected with Leishmania sp. 'siamensis' and HIV	other source
tissue from symptomatic Burmese man	other source
urine from Thai man co-infected with Leishmania sp. 'siamensis' and HIV	urine
urine from symptomatic Burmese man	urine
urine from visceral leishmaniasis in Thai man	urine
Well Water Guinea Bissau	water
anoxic pond in wastewater treatment plant	water
cornea, AK	other source
corneal washing	other source
drinking water reservoir	water
host feces	feces
lens case, AK	other source
liquor, GAE	Unknown
nasale mucosa	Unknown
soil samples from parks and agricultural area	soil
water samples from hot spring	water
water samples from hot spring and swimming pool-soil from parks and agricultural area	water
water samples from hot spring-soil samples from parks and agricultural area	water
water samples from swimming pool-soil samples from parks and agricultural area	water
water treatment plant	water
Boiling Springs Lake	water
drinking water network	water
Anas platyrhynchos	Unknown
Anas platyrhynchos exp.infection	Unknown
Anisus vortex	Unknown
Gyraulus albus exp. infection	Unknown
Lake Albert	water
Lake Albert region	water
Lake Malawi	water
Lake Malawi-Chembe	water
Lake Malawi-Likoma	water
Lake Victoria	water
Lake Victoria region	water
Mergus serrator	Unknown
Radix peregra	Unknown
adult female	Unknown
adult male	Unknown
cercariae from the infected snails were used to infect rabbits	Unknown
cercariae from the infected snails were used to infect rabbits, which were perfused to provide the worms for the study	Unknown
eggs	Unknown
furcocercariae	Unknown
intestinal veins	other source
intestinal wall	other source
liver; lung; intestine	other source
miracidia	Unknown
nasal tissue	Unknown
wild	Unknown
