Pan troglodytes (chimpanzee)	chimpanzee
Pan troglodytes vellerosus	chimpanzee
Pan troglodytes schweinfurthii	chimpanzee
Pan troglodytes troglodytes	chimpanzee
Macaca nemestrina	monkey
Pan paniscus (bonobo)	bonobo
human red blood cells	Mammals - human
Mus musculus	mouse
Macaca fascicularis	monkey
Thamnomys rutilans	rat
Grammomys surdaster	rat
human	Mammals - human
Macaca mulatta	monkey
Anopheles funestus	mosquito
Homo sapiens	Mammals - human
human erythrocytes	Mammals - human
Homo sapiens; asymptomatic child	Mammals - human
Pan troglodytes verus	chimpanzee
Pan troglodytes	chimpanzee
Pan troglodytes scheinfurthii	chimpanzee
macaque	monkey
Gorilla gorilla	gorilla
Cercopithecus nictitans	monkey
Mytilus edulis	mussel
Agapornis roseicollis	other bird
Equus caballus	horse
deer mouse	mouse
Hydrochoerus hydrochoeris (Capybara)	other rodent
Apodemus flavicollis	mouse
Homo sapiens child	Mammals - human
king snake	snake
Canis lupus familiaris	dog
Oryctolagus cuniculus	rabbit
black duck	duck
Serinus canaria	other bird
Padda oryzivora (White Java Sparrow)	sparrow
Phascolarctos cinereus (koala)	koala
Canis familiaris (dog)	dog
Easter gray squirrel	squirrel
Sporophila collaris (rusty-collared seedeater)	other bird
desert monitors	monitors
Galerida cristata (Crested Lark)	other bird
mountain goat	goat
Anser anser f. domestica	goose
Tetrao urogallus (western capercaillie)	other bird
mammals	other mammal
Gallus gallus domesticus (domestic chicken)	chicken
Pavo cristatus (Indian peafowl)	other bird
Lates calcarifer (Asian seabass)	other fish
Coragyps atratus (black vulture)	vulture
house rat	rat
Coturnix japonica	quail
Bos taurus	cow
Prezewalski's wild horse	horse
Corbicula	clam
Canis familiaris	dog
Fulica atra	other bird
Furcifer oustaleti	chameleon
Savannah monitor	monitors
Connochaetes gnou	wildebeest
Eurasian woodcock	woodcock
Columba livia (Fan-tailed Pigeon)	dove
Felis cattus (cat)	cat
red kangaroo	kangaroo
Varanus exanthematicus	monitors
opossum	possum
Pterophyllum scalare	other fish
Cavia porcellus	guinea pig
Gouldian finch	finch
Testudo marginata	tortoise
Testudo hermanni	tortoise
Tachyoryctes splendens (East African mole rat)	rat
yellow rat snake	snake
Petrogale xanthopus (yellow-footed rock wallaby)	wallaby
Cyanocompsa brissonii (ultramarine grosbeak)	other bird
Hemitheconyx caudicinctus	gecko
Spermophilus beecheyi	squirrel
Malacochersus tornieri	tortoise
Apodemus speciosus	mouse
'Taihe Silky' Chicken	chicken
Sicalis flaveola (saffron finch)	finch
Bos taurus, cattle feces	cow
Bos taurus, calf	cow
Ovis aries	sheep
Erinaceus europaeus L. (European hedgehog)	other mammal
mink	other mammal
avian	other bird
Chlamydosaurus kingii	lizard
bovine calf	cow
Vicugna pacos	alpaca
crossbred bovine	cow
bobcat	cats
Ovis aries (sheep)	sheep
alpaca (Lama pacos)	alpaca
Amazon tree boa	snake
Macropus fuliginosus	kangaroo
Equus przewalskii (Prezewalski's wild horse)	horse
desert monitor	monitors
aurora finch	finch
house mouse	mouse
Coendou prehensilis	porcupine
Taeniopygia guttata (Zebra Finch)	finch
mammal	other mammal
Serinus canaria (canary)	finch
Cervus elaphus	deer
Sus scrofa	pig
Homo sapiens, human feces	Mammals - human
Nymphicus hollandicus	other bird
Lampropeltis triangulum	snake
Streptopelia orientalis (Rufous Turle Dove)	dove
Macaca sinica sinica	monkey
Capra hircus	goat
Bos taurus (Holstein cow)	cow
Capra hircus (goat)	goat
Gorilla gorilla gorilla	gorilla
Nymphicus hollandicus (cockatiel)	other bird
Nymphicus hollandicus (cockatieli)	other bird
plum-headed finch	finch
Camelus bactrianus (bactrian camel)	camel
Black Bear	bear
pigeon	dove
Agapornis roseicollis (peach-faced lovebird)	other bird
deer via calf	deer
'Gushi' Chicken	chicken
Bombycilla garrulus (Bohemian Waxwing)	other bird
Anas platyrhynchos	mallard
Meleagris gallopavo	turkey
Bos taurus (Holstein calf)	cow
Clethrionomys glareolus	vole
beef cattle	cow
bull snake	snake
broiler chicken	chicken
Apodemus sylvaticus	mouse
rhesus monkey	monitors
black-and-white colobus monkey	monkey
Hippotragus niger	antelope
goat kid	goat
buffalo calf	cow
Lampropeltis getula nigritus	snake
Microtus arvalis	vole
Padda oryzivora	sparrow
Oryctolagus cuniculus (rabbit)	rabbit
giant panda	bear
Phoca vitulina	seal
Mustela putorius furo	ferret
Rattus norvegicus; AB200	rat
Rattus norvegicus; AB193	rat
ovis aries	sheep
Macropus giganteus	kangaroo
Sciurus vulgaris	squirrel
Gekko sp.	gecko
Apodemus flavicollis; AB164	mouse
red-faced Aurora finch	finch
Sparus aurata (gilthead sea bream)	other fish
Boa constrictor ortoni	snake
Boa constrictor	snake
Acridotheres tristis (common myna)	other bird
Rattus norvegicus; AB205	rat
Spermophilus beldingi	squirrel
Erinaceus europaeus	other mammal
Lampropeltis getula californiae	snake
Mirounga leonina (southern elephant seal)	seal
Gallus gallus	chicken
bactrial camel	camel
birds	other bird
Vulpes vulpes (red fox)	fox
Semnopithecus entellus thersites	monkey
red colobus monkey	monkey
Bos taurus, cattle	cow
Chamaeleo calyptratus	chameleon
cow calf	cow
hamster	other rodent
Elaphe guttata guttata	snake
baboon	monkey
dairy cow	cow
star tortoise	tortoise
dairy calf	cow
Macropus rufus	kangaroo
Coturnix coturnix (quail)	quail
Ailuropoda melanoleuca	bear
Homosapiens	Mammals - human
domestic mouse	mouse
Python regius	snake
Tragelaphus angasi	antelope
Oryzoborus maximiliani (great-billed seed-finch )	finch
rabbit (Oryctolagus cuniculus)	rabbit
Bactrian camel	camel
Perameles bougainville (bandicoot)	bandicoot
Maccullochella peelii peelii (Murray cod)	other fish
Leiothrix argentauris (Silver-eared Liocichla)	other bird
Bos taurus (cattle)	cow
Spermophilus lateralis	squirrel
calf	cow
Homo sapins	Mammals - human
common brushtail possum (Trichosurus vulpecula)	possum
Felis catus	cat
black and white dairy cattle	cow
slug	other mollusk
Eublepharis macularius	gecko
Iguana iguana	iguana
Eublepharis macularis	gecko
Eastern chipmunk	chipmunk
ostrich (Struthio camelus)	ostrich
gouldian finch	finch
pig genotype II	pig
Xenagama sp.	lizard
laboratory mouse	mouse
Leiothrix lutea (Red-billed Leiothrix)	other bird
Tachyoryctes	other rodent
Rattus norvegicus (brown rat)	rat
rock hyrax	other mammal
tawny frogmouth	other bird
Clethrionomys rufocanus bedfordiae	vole
Psittacula krameri	other bird
Taihe silky chicken	chicken
cattle	cow
bovine	cow
dairy cattle	cow
Bos Taurus	cow
Procyon lotor (raccoon)	raccoon
Branta canadensis	goose
Bubalus bubalis	water buffalo
bird	other bird
Dolichotis patagonum	other rodent
Pantherophis guttatus	snake
Trachypithecus vetulus philbricki	monkey
Gallus gallus layer	chicken
Trichosurus vulpecula (common brushtail possum)	possum
Capreolus capreolus (roe deer)	deer
New Guinea Boa snake	snake
mussel (Mytilus)	mussel
Mouflon sheep	sheep
Bos mutus (wild yak)	yak
Phoca hispida	seal
Capra ibex	goat
Macropus giganteus (kangaroo)	kangaroo
Oryzoborus angolensis	finch
Urocissa erythrorhyncha (Red-billed Blue Magpie)	other bird
Pica pica (Black-billed Magpie)	other bird
Chloebia gouldiae (Gouldian Finch)	finch
Eumeces schneideri	other reptile
Giraffa camelopardalis reticulata (reticulated giraffe)	giraffe
Lonchura striata domestica	finch
Agrionemys horsfieldii	tortoise
Cervus nippon Temminck (sika deer)	deer
Phascolarctos cinereus	koala
Syncerus caffer	buffalo
lettuce	Unknown
Leopard gecko	gecko
Apis mellifera (honey bee)	bee
Apis koschevnikovi	bee
Apis mellifera iberiensis	bee
Apis mellifera	bee
Apis cerana	bee
Apis dorsata	bee
Apis florea	bee
Bombus sp.	bumblebee
Bombus lucorum	bumblebee
Bombus affinis	bumblebee
Bombus vosnesenskii	bumblebee
Bombus sporadicus	bumblebee
Bombus terricola	bumblebee
Bombus consobrinus	bumblebee
Bombus schrencki	bumblebee
Bombus sichelii	bumblebee
Bombus terrestris	bumblebee
Bombus bifarius	bumblebee
Bombus bimaculatus	bumblebee
Bombus occidentalis	bumblebee
Bombus pensylvanicus	bumblebee
Bombus hypnorum	bumblebee
Bombus sitkensis	bumblebee
Bombus impatiens	bumblebee
Bombus saltuarius	bumblebee
Yorkshire terrier	dog
Abraxas grossularia	Insects
Oncorhynchus mykiss (rainbow trout)	other fish
Phyllobrotica armata Baly	Insects
Spodoptera exigua	moth
dachshund	dog
Raccoon	raccoon
marmoset	monkey
Oulema melanopus L.	Insects
Plutella xylostea	moth
Plutella xylostae	moth
miniature poodle	dog
chihuahua	dog
Muskrat	muskrat
Pieris rapae L.	butterfly
Pieris rapae (Linnaeus)	butterfly
Choristoneura fumiferana	moth
Choristoneura pinus pinus	moth
Choristoneura conflictana	moth
Choristoneura occidentalis	moth
maltese	dog
Conistra vaccinii	moth
Beaver	beaver
Calospilos suspecta	moth
Spodoptera litura	moth
Salmo salar (Atlantic salmon)	salmon
Salmo trutta	salmon
Salmo salar (escaped farmed Atlantic salmon)	salmon
Salmo salar	salmon
Lepeophtheirus salmonis (adult female)	Crustacean
Lepeophtheirus salmonis	Crustacean
rhesus macaque	monkey
Gammarus roeseli	Crustacean
Gammarus duebeni celticus	Crustacean
Cancer pagarus	Crustacean
Hyblaea puera (teak moth)	moth
Merops apiaster	other bird
Cydia pomonella	moth
Henerophila atrilineata	Unknown
Hemerophila atrilineata Butler	Unknown
Malacosoma disstria	moth
pomeranian	dog
Arion subfuscus	other mollusk
Operophtera brumata	moth
Sus scrofa domestica	pig
Ostrinia furnacalis	moth
Oncorhynchus tshawytscha	salmon
Samia cynthia ricini	moth
Antheraea assama	silkworm
Pacifastacus leniusculus	Crustacean
Caenorhabditis briggsae	Nematodes
swine	pig
Fox	fox
Caligus elongatus	Crustacean
Caenorhabditis elegans	Nematodes
silkworm, Bombyx mori	silkworm
Bombyx mori (silkworm)	silkworm
Bombyx mori	silkworm
roe deer	deer
red deer	deer
Odocoileus virginianus (White-tailed deer)	deer
Equus caballi	horse
Bos taurus (domestic cow)	cow
Rangifer tarandus	reindeer
caribou (Rangifer tarandus caribou)	reindeer
Bos sp.	cow
cow breed Karabuk	cow
white-tailed deer (Odocoileus virginianus)	deer
Cervus elaphus (Red deer)	deer
Clethrionomys sp.	vole
mule deer	deer
capybara (Hydrochaeris hydrochaeris)	other rodent
Canis familaris	dog
Black tailed jackrabbit (Lepus californicus)	hare
Sorex	other mammal
roan antelope	antelope
Bos taurus (Angus x Hereford)	cow
Bos taurus, Cattle (No. Bogd-34)	cow
Bos taurus, Cattle (No. F67)	cow
Bos taurus, Cattle (No. Ja-16)	cow
Bos taurus, Cattle (No. Ja-31)	cow
Bos taurus, Cattle (No. Undur-6)	cow
Bos taurus, Cattle (No. UL-19)	cow
Bos taurus, Cattle (No. F35)	cow
Bos taurus, Cattle (No. F13)	cow
Bubalus arnee, Water Buffalo (No. 9)	water buffalo
Bos taurus breed Japanese black x Hereford, isolate 34 (ToSM3)	cow
white-tailed deer from Central and East Texas in USA, elk from Canada	deer
Bubalus arnee, Water Buffalo (No. 2)	water buffalo
Friesian cow	cow
Bubalus arnee, Water Buffalo (No. 59)	water buffalo
Bos taurus, Cattle (No. 58)	cow
Ursus arctos yesoensis	bear
Lagurus luteus	other rodent
domestic cat	cat
Ixodes ricinus; female	Unknown
Clethrionomys	vole
Clethrionomys rutilus	vole
Blastoceros dichotomus	deer
Florida panther	cats
dog 235	dog
dog 195	dog
Haemaphysalis concinna	Unknown
Dermacentor variabilis	Unknown
Bos taurus, Cattle (No. UL-1)	cow
Bos taurus, Cattle (No. Ja-10)	cow
Bos taurus, Cattle (No. UL-29)	cow
Bos taurus, Cattle (No. Bogd-13)	cow
Bos taurus, Cattle (No. Bi-24)	cow
Bos taurus, Cattle (No. UL-33)	cow
Bos taurus, Cattle (No. F14)	cow
Bos taurus, Cattle (No. UL-36)	cow
white-tailed deer	deer
Bos taurus breed Hereford, isolate 72 (ToHp2)	cow
Bos taurus, Cattle (No. 94)	cow
Bubalus arnee, Water Buffalo (No. 11)	water buffalo
Bubalus arnee, Water Buffalo (No. 5)	water buffalo
Bos taurus, Cattle (No. 36)	cow
Ovis aries breed Longde	sheep
Bos taurus, Cattle (No. 93)	cow
Bos taurus breed Holstein, isolate 60 (ToTM1)	cow
Bos taurus, Cattle (No. 68)	cow
Bubalus arnee, Water Buffalo (No. 3)	water buffalo
Bos taurus, Cattle (No. 83)	cow
Bubalus arnee, Water Buffalo (No. 29)	water buffalo
Bubalus arnee, Water Buffalo (No. 36)	water buffalo
Hippotragus equinus	antelope
Equus caballus (horse)	horse
Iberian lynx	cats
Ixodes ricinus	Unknown
Ixodes ricinus; male	Unknown
Ixodes persulcatus	Unknown
stray dog	dog
musk ox (Ovibos moschatus)	other mammal
Acinonyx jubatus	cats
Capreolus capreolus	deer
Apodemus agrarius	mouse
Myodes glareolus	vole
Capra ibex (Alpine ibex)	goat
dog 163	dog
Giraffa camelopardalis (giraffe)	giraffe
Amblyomma americanum	Unknown
Bos taurus, Cattle (No. Bi-12)	cow
Bos taurus, Cattle (No. Undur-1)	cow
Bos taurus, Cattle (No. Ts-8)	cow
Bos taurus, Cattle (No. Bogd-19)	cow
Bos taurus, Cattle (No. Bogd-36)	cow
Bos taurus, Cattle (No. F40)	cow
Bos taurus, Cattle (No. Bogd-38)	cow
Bos taurus, Cattle (No. Ja-22)	cow
Rhipicephalus (Boophilus), Cattle tick (No. B38)	Unknown
Bos taurus breed Angus, isolate 13 (ToSp2)	cow
Bos taurus Japanese black	cow
Bubalus arnee, Water Buffalo (No. 38)	water buffalo
Bos taurus, Cattle (No. 92)	cow
cow, buffalo	Mammals - non human
Bubalus arnee, Water Buffalo (No. 18)	water buffalo
Bos taurus, Cattle (No. 81)	cow
feline	cat
Tragelaphus strepsiceros	antelope
Bos taurus breed Angus, isolate 10 (ToSM2)	cow
Bos taurus, Cattle (No. 56)	cow
Ovis aries breed Weiyuan	sheep
Roe deer	deer
Dermacentor reticulatus	Unknown
Ixodes dammini	Unknown
black bear	bear
Rupicapra rupicapra rupicapra (Chamois)	other mammal
fallow deer	deer
Ixodes trianguliceps	Unknown
shrew	other mammal
Dermacentor nuttalli	Unknown
Odocoileus hemionus	deer
Peromyscus	other rodent
Ixodes ricinus (tick)	Unknown
Canis lupus domesticus (American pit bull terrier)	dog
Mazama gouazoupira	deer
Microtus agrestis	vole
dog 056	dog
desert cottontail rabbit (Sylvilagus audubonii)	rabbit
Rhipicephalus evertsi evertsi	Unknown
Syncerus caffer (African buffalo)	buffalo
Synercus kaffer	buffalo
Bos taurus, Cattle (No. Ts-22)	cow
Bos taurus, Cattle (No. F4)	cow
Bos taurus, Cattle (No. UL-4)	cow
Bos taurus, Cattle (No. Ja-24)	cow
Bos taurus, Cattle (No. UL-38)	cow
Bos taurus, Cattle (No. Bi-17)	cow
Bos taurus, Cattle (No. Bi-31)	cow
Bos taurus, Cattle (No. Ja-35)	cow
Bos taurus, Cattle (No. Bi-28)	cow
Bos taurus breed Angus, isolate 13 (ToSM1)	cow
Bos taurus, Cattle (No. 69)	cow
Bos taurus, Cattle (No. 105)	cow
Bos taurus, Cattle (No. 108)	cow
Bos taurus Holstein	cow
Bubalus arnee, Water Buffalo (No. 39)	water buffalo
cattle from Cheju, Korea; elk from Minnesota, USA	Mammals - non human
Bos taurus, Cattle (No. 111)	cow
Bos indicus	cow
Capricornis crispus	goat
African buffalo (Syncerus caffer)	buffalo
Cervus elaphus (red deer)	deer
reindeer (Rangifer tarandus tarandus)	reindeer
Rhipicephalus sanguineus s.l.	Unknown
Paguma larvata	other mammal
Odocoileus virginianus (white-tailed deer)	deer
Ixodes ricinus; nymph	Unknown
canine	dog
domestic dog; breed German shepherd	dog
Capreolus capreolus (European roe deer)	deer
domestic dog	dog
Ursus thibetanus japonicus	bear
small bighorn sheep	sheep
Macaca fuscata	monkey
Canis familiaris isolate 55	dog
Canis familiaris isolate 28	dog
Bos taurus, Cattle (No. Bi-9)	cow
Bos taurus, Cattle (No. Ja-8)	cow
Bos taurus, Cattle (No. UL-5)	cow
Bos taurus, Cattle (No. Ja-27)	cow
Bos taurus, Cattle (No. Ja-41)	cow
Bos taurus, Cattle (No. Ts-9)	cow
Bos taurus, Cattle (No. F38)	cow
Bos taurus, Cattle (No. F33)	cow
Rhipicephalus (Boophilus), Cattle tick (No. B1)	cow
Bos taurus, Cattle (No. F23)	cow
Bos taurus, Cattle (No. Ja-19)	cow
Bos taurus, Cattle (No. Bi-15)	cow
Bos taurus, Cattle (No. Ts-15)	cow
grazing cattle	cow
sika deer	deer
Bos taurus breed Japanese Short Horn, isolate 71 (ToHM2)	cow
sheep and goat	Mammals - non human
Bos taurus, Cattle (No. 266)	cow
cheetah	cats
Dermacentor nuttalli; isolated from horse	horse
Bos taurus, Cattle (No. 51)	cow
Bos taurus, Cattle (No. 72)	cow
naturally infected goat	goat
Bubalus arnee, Water Buffalo (No. 22)	water buffalo
Bos taurus, Cattle (No. 129)	cow
Bos taurus, Cattle (No. 109)	cow
Bubalus arnee, Water Buffalo (No. 12)	water buffalo
Bos taurus, Cattle (No. 90)	cow
Bos taurus breed Holstein, isolate 55 (ToTp1)	cow
Bos taurus, Cattle (No. 59)	cow
Bos taurus, Cattle (No. 70)	cow
Giraffa camelopardalis	giraffe
Rangifer tarandus tarandus (reindeer)	reindeer
Ixodes ricinus tick	Unknown
Rattus sp.	rat
Rattus coxinga	rat
naturally infected dog	dog
Rhipicephalus sanguineus	Unknown
Canis lupus familiaris (dog)	dog
Microtus oeconomus	vole
pet dog	dog
Microtus	vole
Capreolus capreolus (Roe deer)	deer
Dama dama	deer
Microtus sp.	vole
Eastern cottontail rabbit (Sylvilagus floridanus)	rabbit
Rupicapra rupicapra (Chamois)	other mammal
Pipistrellus sp.	other mammal
free-roaming cat	cat
Haemaphysalis japonica	Unknown
tick	Unknown
equine	horse
Sus scrofa domesticus	pig
Bos taurus, Cattle (No. F9)	cow
Bos taurus, Cattle (No. UL-17)	cow
Rhipicephalus (Boophilus), Cattle tick (No. B34)	cow
Bos taurus, Cattle (No. Ts-10)	cow
ocelot	cats
Bos taurus breed Hereford, isolate 44 (ToHM1)	cow
puma	cats
Bos taurus breed Hereford, isolate 44 (ToHp3)	cow
Bos taurus breed Hereford, isolate 73 (ToHM3)	cow
Bos taurus breed Japanese black x Hereford, isolate 34 (ToSp1)	cow
dama gazelle	gazelle
Rupicapra pyrenaica prenaica (Pyrenean chamois)	other mammal
Myodes rufocanus	vole
Ixodes ricinus (female)	Unknown
elk (Cervus elaphus canadensis)	elk
leopard	cats
lion	cats
Dermacentor reticulatus; female	Unknown
Hyalomma asiaticum	Unknown
Bos taurus erythrocyte	cow
Larus cachinnans	gull
Cervus elaphus canadensis	elk
Peromyscus sp.	other rodent
Bettongia penicillata	marsupial
dog 178	dog
dog (Canis familiaris)	dog
Bos taurus, Cattle (No. Ja-14)	cow
Bos taurus, Cattle (No. F65)	cow
Bos taurus, Cattle (No. Ja-18)	cow
Bos taurus, Cattle (No. F36)	cow
Bos taurus, Cattle (No. Ts-30)	cow
Bos taurus, Cattle (No. F42)	cow
Bos taurus, Cattle (No. UL-37)	cow
Bos taurus, Cattle (No. UL-13)	cow
Bos taurus, Cattle (No. UL-7)	cow
Rhipicephalus (Boophilus), Cattle tick (No. A29)	cow
Bos taurus, Cattle (No. UL-22)	cow
Bos taurus, Cattle (No. Ja-33)	cow
Bos taurus, Cattle (No. Bi-3)	cow
Odocoileus virginianus	deer
Bos taurus, Cattle (No. 104)	cow
Bos taurus, Cattle (No. 62)	cow
Bubalus arnee, Water Buffalo (No. 26)	water buffalo
Bubalus arnee, Water Buffalo (No. 34)	water buffalo
Bubalus arnee, Water Buffalo (No. 42)	water buffalo
Bubalus arnee, Water Buffalo (No. 33)	water buffalo
Bos taurus, Cattle (No. 85)	cow
Bos taurus breed Hereford, isolate 32 (ToHp1)	cow
Bubalus arnee, Water Buffalo (No. 27)	water buffalo
Dama dama (fallow deer)	deer
Leopardus pardalis (ocelot)	cats
Sus scrofa (wild boar)	pig
Clethrionomys rufocanus	vole
Papio cynocephalus	monkey
Rhipicephalus bursa	Unknown
Myodes rutilus	vole
Hyalomma marginatum	Unknown
Canis sp.	dog
chamois	other mammal
Hippotragus niger (sable antelope)	antelope
Canis familiaris isolate 21	dog
Bos taurus, Cattle (No. F41)	cow
Bos taurus, Cattle (No. Bogd-37)	cow
Bos taurus, Cattle (No. Bogd-35)	cow
Bos taurus, Cattle (No. F7)	cow
Bos taurus, Cattle (No. Da-38)	cow
Bos taurus, Cattle (No. F8)	cow
Bos taurus, Cattle (No. Undur-2)	cow
Bos taurus, Cattle (No. UL-12)	cow
Bos taurus, Cattle (No. Ja-59)	cow
Bos taurus, Cattle (No. Undur-8)	cow
Bos taurus, Cattle (No. F11)	cow
Bos taurus, Cattle (No. F46)	cow
ovine	sheep
Rhipicephalus appendiculatus	Unknown
Bubalus arnee, Water Buffalo (No. 31)	water buffalo
Cervus nippon centralis	deer
Bubalus arnee, Water Buffalo (No. 6)	water buffalo
Cervus nippon	deer
Bos taurus, Cattle (No. 77)	cow
Bos taurus, Cattle (No. 161)	cow
Bos taurus, Cattle (No. 49)	cow
Felis domesticus (domestic cat)	cat
Bettongia lesueur	marsupial
Gazella dama mhorr	gazelle
bovids	cow
buffalo 403	buffalo
buffalo 412	buffalo
buffalo 419	buffalo
buffalo 410	buffalo
buffalo 406	buffalo
Bubalus bubalis (water buffalo)	water buffalo
Human (CT??)	Mammals - human
Human (CT**)	Mammals - human
Human	Mammals - human
Human (CT)	Mammals - human
Human (AIDS)	Mammals - human
human, congenital	Mammals - human
human,kidney transplant	Mammals - human
human,Congenital	Mammals - human
human, lymphoma	Mammals - human
huamn	Mammals - human
 human	Mammals - human
human,Transplant	Mammals - human
human, AIDS	Mammals - human
human, ocular infection	Mammals - human
human,transplant	Mammals - human
human,Encephalitis	Mammals - human
human,AIDS	Mammals - human
human,AIDS,	Mammals - human
human,congenital	Mammals - human
Felis catus (cat)	cat
cat (Felis domesticus)	cat
cat (Felis catus)	cat
Brazilian Cat	cat
Cat	cat
naturally infected cat (Felis catus)	cat
Cats	cat
female dog	dog
dogs	dog
Sri Lanka dog	dog
male dog	dog
Dogs	dog
dog/dingo hybrid; dog from an Aboriginal community	dog
Vulpes vulpes	fox
Vulpes lagopus; final host	fox
Vulpes vulpes; final host	fox
Atheris rungweensis (Mt. Rungwe Bush Viper)	snake
Atheris rungweensis (Mt Rungwe Bush Viper)	snake
Xanthomyza phrygia (Regent Honeyeater)	other bird
Argentine Didelphis albiventris	possum
Virginia opossum (Didelphis virginiana)	possum
Florida Didelphis virginiana	possum
Brazilian Didelphis albiventris	possum
Mississippi Didelphis virginiana	possum
Molothrus ater	other bird
Sturnus vulgaris	other bird
cowbird (Molothrus ater)	other bird
Columba livia	other bird
Accipiter gentilis gentilis	other bird
Accipiter sp.	other bird
Accipiter cooperii	other bird
African grey parrot	other bird
Grus vipio	crane
Grus japonensis	crane
Grus monacha	crane
Larus marinus (black-backed gull)	gull
Golden Eagle	eagle
Bald Eagle	eagle
raccoon (Procyon lotor)	raccoon
Puma concolor	cougar
cougars	cougar
warm blooded animals	Unknown
chichens	chicken
Striped dolphin	dolphin
feed, cat	Unknown
chicken, chronic	chicken
goat, chronic	goat
arctic fox	fox
Phaedon brassicae	other insect
Alburnus alburnus	other fish
Gymnocephalus cernuus	other fish
Hypophthalmichthys molitrix	other fish
Chlamys islandica	other mollusk
California sea otter (Enhydra lutris nereis)	otter
Alaska Sea otter (Enhydra lutris kenyoni)	otter
Rangifer tarandus tarandus	reindeer
Pica pica	other bird
Bison bonasus bonasus (European bison)	bison
Suricata suricatta (slender tailed meerkat)	mongoose
Buteo lineatus	hawk
Arctocephalus townsendi	seal
Cougar	cougar
Turkey, chronic	turkey
Taurulus bubalis	other fish
Rutilus rutilus	other fish
Gobius fluviatilis	other fish
Sander lucioperca	other fish
commercial broiler chicken	chicken
Anser anser	goose
Ceratotherium simum simum (southern white Rhinoceros)	rhinoceros
Ceratotherium simum simum (Southern White Rhinoceros)	rhinoceros
Sminthopsis crassicaudata (fat-tailed dunnart); experimentally infected dunnart (E2)	marsupial
Eptesicus fuscus	bat
Sorex araneus	other mammal
Sorex araneus (European shrews)	other mammal
Macropus parma	wallaby
warm-blooded mammals	other mammal
Sheep	sheep
Pig	pig
Feral cats	cat
Dove 	dove
deer, chronic	deer
Gobio gobio	other fish
Gaultheria mucronata	Unknown
Gallus gallus domesticus	chicken
Gallus domesticus	chicken
Anser albifrons	goose
Rattus ruttus	rat
Martes pennanti (fisher)	other mammal
Enhydra lutris nereis	otter
Pseudocerastes persicus (Persian Horned Viper)	snake
Leuciscus cephalus	other fish
Thylamys elegans	possum
corvid birds	crow
free-living jaguar (Panthera onca)	jaguar
mammals and some birds	Unknown
Physeter macrocephalus	other mammal
Bottlenose Dolphin, stranded	dolphin
arctic foxes	fox
bear, chronic	bear
Pig (pork from retail meet store)	pig
Acerina cernua	other fish
Gobius kessleri	other fish
Gobius melanostomus	other fish
Abramis brama	other fish
Abramis sapa	other fish
Anguilla anguilla	other fish
Acipenser ruthenus	other fish
Blicca bjoerkna	other fish
Passer domesticus	sparrow
Northern house sparrow (Passer domesticus)	sparrow
domestic rabbit	rabbit
Panthera tigris altaica (Siberian tiger)	cats
Branta leucopsis	goose
Southern sea otter	otter
Rattus norvegicus	rat
Phalacrocorax carbo (great cormorant)	other bird
double-crested cormorant (Phalacrocorax auritus)	other bird
wild boar	boar
Sea otters	otter
Chickens	chicken
Indonesia chicken	chicken
human or rabbit	Unknown
Toucan	toucan
Lates calcarifer (Barramundi)	other fish
Aristichthys nobilis	other fish
pigs	pig
sheep, chronic	sheep
California horse	horse
Perca fluviatilis	other fish
Cyprinus carpio	other fish
Podarcis hispanica	lizard
Podarcis lilfordi	lizard
Turdus merula	thrush
intermediate host: Rangifer tarandus tarandus	reindeer
Capreolus capreolus (intermediate host)	deer
Capreolus capreolus; intermediate host	deer
Atheris desaixi (Mt. Kenya Bush Viper)	snake
Zalophus californianus (California sea lion)	seal
Nicaragua chicken	chicken
rodent, chronic	rodent
Carassius auratus	other fish
Carassius gibelio	other fish
Barbus barbus	other fish
Gasterosteus aculeatus	other fish
Scardinius erythrophthalmus	other fish
Sciurus carolinensis	squirrel
Corvus cornix (Hooded crow)	crow
Alces alces (intermediate host)	moose
Didelphis virginiana	possum
Ramphastos sulfuratus	toucan
goat with besnoitiosis	goat
chickens	chicken
domestic fowl	other bird
Rhea americana	other bird
Chinchilla sp.	rodent
Astronotus ocellatus	other fish
Macaca mulata	monkey
Colobus guereza kikuyuensis	monkey
Pongo pygmaeus	orangutan
Equus zebra hartmannae	zebra
Gymnocephalus cernua	other fish
Trachypithecus sp.	monkey
Psammobates pardalis	tortoise
Mandrillus leucophaeus	monkey
Aries ovis	sheep
Macaca sylvanus	monkey
E.coli	Unknown
boxer dog	dog
Trachypithecus francoisi	monkey
Trachypithecus auratus	monkey
Silurus glanis	other fish
Trachypithecus phayrei	monkey
boa constrictor	snake
Homo sapience stool	Mammals - human
Lagothrix lagotricha	monkey
Aedes aegypti	mosquito
Papio sp.	monkey
cercopithecoid	monkey
Semnopithecus entellus	monkey
Erythrocebus patas	monkey
rainbow trout	other fish
Phoca vitulina richardsi	seal
Phoca vitulina vitulina	seal
Phoca vitulina vitulina (harbor seal)	seal
Phoca groenlandica (harp seal)	seal
Halichoerus grypus	seal
red tailed guenon	monkey
Ateles fusciceps (black-headed spider monkey)	monkey
Pithecia pithecia	monkey
Cercocebus atys	monkey
Saguinus oedipus	monkey
Trachypithecus auratus (Javan lutung)	monkey
Macaca fuscata (Monkey)	monkey
Cercopithecus hamlyni	monkey
black and white colobus monkey	monkey
Barbary macaque	monkey
mandrill	monkey
Cercopithecus sp.	monkey
Alouatta fusca	monkey
Saimiri boliviensis (black-capped squirrel monkey)	monkey
Alouatta clamitans	monkey
Cercopithecus neglectus	monkey
Callithrix pygmaea	monkey
ape (marmoset)	monkey
Colobus guereza (mantled guereza)	monkey
Papio hamadryas (Hamadryas baboon)	monkey
Eulemur fulvus mayottensis	lemur
Lemur catta (ring-tailed lemur)	lemur
Varecia rubra	lemur
Varecia variegata (black-and-white ruffed lemur)	lemur
Lemur catta	lemur
Eulemur rufus	lemur
Hapalemur aureus	lemur
Eulemur rubriventer	lemur
farmed Salmo salar	salmon
farmed Salvelinus alpinus	salmon
wild Salvelinus alpinus	salmon
wild Salvelinus	salmon
Salvelinus alpinus	salmon
Thymallus thymallus	salmon
Thymallus arcticus baikalensis	salmon
Salomo salar	salmon
Alces alces	moose
Canis latrans	coyote
Bison bison	bison
Gazella thomsoni	gazelle
Capra aegagrus hircus	goat
fish	other fish
Grampus griseus (Risso's dolphin)	dolphin
Castor canadensis	beaver
Felis silvestris catus	cat
Anas strepera	duck
mako shark	shark
Octodon degus	other rodent
Nyctereutes procyonoides	dog
Struthio camelus	ostrich
canis vulgaris	dog
Bolborhynchus lineola	other bird
Tamandua tetradactyla	other mammal
Merlangius merlangus	other fish
Lota lota	other fish
Panthera onca	jaguar
Lagenorhynchus acutus (Atlantic white-sided dolphin)	dolphin
Phocoena phocoena (harbor porpoise)	other mammal
Somateria mollissima (common eider)	other bird
Larus argentatus (Herring gull)	gull
Larus argentatus (herring gull)	gull
Larus sp.	gull
Larus argentatus	gull
jackal	wolf
chinchilla | rodent	other rodent
Gadus morhua	other fish
Chinchilla lanigera	other rodent
Isoodon obesulus	bandicoot
Mesocricetus auratus	other rodent
Delphinus delphis (common dolphin)	dolphin
Urocyon cinereoargenteus	fox
Bos taurus (Watusi)	cow
Melopsittacus undulatus	other bird
Enchelyopus cimbrius	other fish
Delphinus delphis	dolphin
Brosme brosme	other fish
Delphinus delphis (Short-beaked common dolphin)	dolphin
Alopias vulpinus (common thresher shark)	shark
Oryx leucoryx	antelope
Homo sapiens Linne	Mammals - human
goat breed Black Bengal	goat
Antheraea mylitta (tasar silkworm)	silkworm
Anopheles stephensi	mosquito
Puntius tetrazona	other fish
Saurida tumbil	other fish
Epinephelus chlorostigma	other fish
Perca flavescens	other fish
Pagrus pagrus	other fish
Ommatogammarus albinus	other crustacean
Abramis bramis	other fish
Acathocephala femorata ATCC 30251	other bird
Accipiter badius (shikra)	other bird
Accipiter gentilis	other bird
Accipiter nisus	other bird
Accipiter nisus (sparrowhawk)	other bird
Acomys johannis	other rodent
Aedes vexans	mosquito
Aedes vexans ATCC 30268	mosquito
Aeptus singularis	other insect
Akodon boliviensis	other rodent
Allamanda cathartica	Plant
Alpinia purpurata	Plant
Alydinae gen. sp.	other insect
Anoura sp.	bat
Aotus azarai	monkey
Aotus sp.	monkey
Aplastodiscus leucopygius	frog
Apodemus peninsulae	mouse
Apodemus speciosus speciosus	mouse
Aquarius p. paludum	other insect
Aquila pomarina	eagle
Artibeus jamaicensis	bat
Artibeus planirostris	bat
Asclepias curacavica	Plant
Aspilocoryphus fasciativentris	other insect
Bettongia penicillata (woylie)	marsupial
Biting midge (Culicoides cubitalis)	other insect
Blepharodon nitidum	Plant
Bolaca unicolor	Unknown
Bos taurus (cattle no. 10)	cow
Bos taurus (cattle no. 28)	cow
Bos taurus (cattle no. 42)	cow
Bos taurus (cattle no. 43)	cow
Bos taurus (cattle no. 90)	cow
Buffalo	buffalo
Buteo buteo	other bird
Caiman yacare	crocodile
Callithrix jacchus	monkey
Camelus dromedarius (dromedary camels)	camel
Capreolus capreolus (roedeer)	deer
Carassius carassius	other fish
Cardinalis cardinalis	other bird
Carollia perspicillata	bat
Cebus albifrons	monkey
Cebus apella	monkey
Cephalophus monticola	antelope
Cervus dama	deer
Cervus nippon yesoensis (common name: sika deer)	deer
Chamaesyce prostrata	Plant
Chaunus ictericus	toad
Chaunus marinus	toad
Chaunus schneideri	toad
Choloepus hoffmanni	other mammal
Chrotopterus auritus	bat
Chrysomya albiceps	fly
Chrysomya megacephala	fly
Chrysomya putoria	fly
Citrus bergamia	Plant
Clarias angelensis	other fish
Cletus bipunctatus	other insect
Cletus unifasciatus	other insect
Coco nucifera	Plant
Cocos nucifera	Plant
Coendu hoffmanni	Unknown
Connochaetes taurinus (wildebeest)	wildebeest
Coranus sp.	other insect
Corvus frugilegus frugilegus	crow
Cricetus cricetus	other rodent
Crocodylus niloticus	crocodile
Crocuta crocuta (hyaena)	other mammal
Crotalus durissus	snake
Cucurbita sp.	Plant
Culex molestus	mosquito
Culex pipiens	mosquito
Culex tarsalis	mosquito
Culicoides (Oecacta) cubitalis	other insect
Culicoides (Oecacta) truncorum	other insect
Culicoides truncorum	other insect
Cyanomitra olivacea	other bird
Cynomya cadaverina	fly
Dasyprocta aguti	other rodent
Dasyprocta fuliginosa	other rodent
Dasypus	other mammal
Dasypus novemcinctus	other mammal
Dasypus sp.	other mammal
Desmodus rotundus	bat
Didelphis albiventris	possum
Didelphis aurita	possum
Didelphis marsupialis	possum
Dieuches albostriatus	other insect
Dieuches armatipes	other insect
Dieuches pamelae	other insect
Dipetalogaster maxima	other insect
Diplonychus rusticus	other insect
Drosophila melanogaster	fly
Drosophila obscura	fly
Drosophila tristis	fly
Durmia varicornis varicornis	other insect
Dysdercus fasciatus	other insect
Dysdercus poecilus	other insect
Dysdercus suturellus	other insect
Dysdercus suturellus ATCC 30220	other insect
Echimys dasythrix	rat
Ectomocoris fenestratus	other insect
Elaeis guineensis	Plant
Elasmolomus squalidus	other insect
Eliomys quercinus	other rodent
Emberiza citrinella	other bird
Engystomops petersi	frog
Eptesicus brasiliensis	bat
Eptesicus serotinus	bat
Equus burchellii (zebra)	zebra
Esox lucius	other fish
Euphorbia characias	Plant
Euphorbia cyathophora	Plant
Euphorbia heterophylla	Plant
Euphorbia hirta	Plant
Euphorbia hyssopifolia	Plant
Euphorbia pinea	Plant
Euphractus sexcinctus	other mammal
Euryoryzomys macconnelli	rat
Evandromyia infraspinosa	fly
Eysarcoris guttigerus	other insect
Eysarcoris ventralis	other insect
Falco tinnunculus	falcon
Fannia canicularis	fly
Ficedula albicollis	other bird
Ficedula albicollis (collared flycatcher)	other bird
Francolinus lathami	other bird
Fringilla coelebs	other bird
Gadus morhua 'A' (Pisces, Gadidae)	other fish
Gadus morhua fed on by leech Calliobdella nodulifera	other fish
Geocoris varius	other insect
Gerris (Macrogerris) sp.	other insect
Gerris comatus	other insect
Gerris lacustris	other insect
Gerris rufoscutellatus	other insect
Gilbert's potoroo (Potorus gilbertii)	marsupial
Glossina morsitans morsitans	fly
Glossina pallidipes	fly
Glossina palpalis	fly
Glossina palpalis gambiensis	fly
Glossina swynnertoni	fly
Gyndes sp.	Unknown
Haemadipsa zeylanica	Annelids
Heteromyias albispecularis	other bird
Hippoboscid fly (Ornithomyia avicularia)	fly
Hippoglossus hippoglossus fed on by leech Johanssonia arctica	other fish
Hippopotamus amphibius (hippopotamus)	hippopotamus
Holochilus brasiliensis	rat
Homo sapiens bone marrow	Mammals - human
Homo spaiens	Mammals - human
Iphita limbata	other insect
Iranian sandfly	fly
Jatropha macrantha	Plant
Kobus ellipsiprymnus (waterbuck)	antelope
Kobus vardonii (puku)	antelope
Leiobdella jawarerensis	Annelids
Lepidorhombus whiffiagonis (Pisces, Scophthalmidae)	other fish
Leptocoris trivittatus ATCC 30265	other insect
Leptocorisa lepida	other insect
Leptodactylus chaquensis	frog
Leptodactylus pentadactylus	frog
Leptopterna dolabrata	other insect
Lesser-spotted eagle (Aquila pomarina)	eagle
Limnogonus hypoleucus	other insect
Liorhyssus hyalinus	other insect
Lophostoma silvicolum	bat
Lucilia cuprina	fly
Lucilia eximia	fly
Lucilia sp.	fly
Lutzomyia almerioi	fly
Lutzomyia caballeroi	fly
Lutzomyia gomezi	fly
Lutzomyia longipalpis	fly
Lutzomyia peruensis	fly
Lutzomyia tuberculata	fly
Lycopersicon esculentum	Plant
Lycopersicon esculentum (tomato)	Plant
Macaca sp.	monkey
Macropus giganteus giganteus	kangaroo
Mandevilla scabra	Plant
Manihot esculenta	Plant
Mastomys erythroleucus	mouse
Mastomys natalensis	mouse
Megaselia scalaris	fly
Megaselia scalaris ATCC 30209	fly
Melamphaus faber	other insect
Melanogrammus aeglefinus (Pisces, Gadidae)	other fish
Meliphaga notata	other bird
Melophagus ovinus	fly
Mepraia spinolai	other insect
Metochus sp.	other insect
Micobdella sp.	Annelids
Mirperus jaculus	other insect
Mixophyes flaeyi	frog
Molossus molossus	bat
Monodelphis brevicaudata	possum
Monodelphis domestica	possum
Monodelphis sp.	possum
Mops condylurus	bat
Mosquito (Culex pipiens)	mosquito
Musca domestica	fly
Musca domestica ATCC 30260	fly
Muscina stabulans	fly
Muscina stabulans ATCC 30708	fly
Myotis albescens	bat
Myotis levis	bat
Myotis nigricans	bat
Myotis ruber	bat
Myotis sp.	bat
Nabicula flavomarginata	other insect
Nabis brevis	other insect
Nabis flavomarginatus	other insect
Nagusta cf. punctaticollis	other insect
Nandinia binotata	other mammal
Nasua nasua	raccoon
Nesokia indica	rat
Noctilio albiventris	bat
Nyctalus noctula	bat
Ochrochira sp.	Unknown
Oncopeltus fasciatus ATCC 12982	other insect
Oncopeltus sp.	other insect
Ornidia obesa	fly
Ornithohynchus anatinus	other mammal
Ornithomyia avicularia	fly
Ornithomyia avicularia (hippoboscid fly)	fly
Ornithorhynchus anatinus	platypus
Oryzomys capito	other rodent
Ovies aries	sheep
Oxymycterus sp.	other rodent
Pachycephala pectoralis	other bird
Panorpa communis	fly
Panstrongylus geniculatus	other insect
Panstrongylus megistus	other insect
Panthera leo	lion
Panthera leo (lion)	lion
Parus caeruleus	other bird
Peckia ingens	fly
Petrogale penicillata	marsupial
Phacochoerus africanus (warthog)	pig
Phaenica sericata TCPD,USP	fly
Philaemon sp.	other bird
Philander frenata	possum
Philander frenatus	possum
Philander opossum	possum
Phlebotomus	fly
Phlebotomus alexandri Paraphlebotomus	fly
Phlebotomus argentipes	fly
Phlebotomus balcanicus	fly
Phlebotomus kandelakii	fly
Phlebotomus kazeruni, phlebotomine sand fly	fly
Phlebotomus martini	fly
Phlebotomus neglectus Larroussius	fly
Phlebotomus papatas Phlebotomusi	fly
Phlebotomus papatasi	fly
Phlebotomus papatasi Phlebotomus	fly
Phlebotomus sergenti	fly
Phlebotomus sergenti (sand fly)	fly
Phlebotomus simici Adlerious	fly
Phlebotomus tobbi	fly
Phlebotomus tobbi Larroussius	fly
Phyllomedusa sp.	frog
Phylloscopus collybita	other bird
Phylloscopus sibilatrix	other bird
Phyllostomus discolor	bat
Phyllostomus hastatus	bat
Phyllostomus sp.	bat
Phyllotis osilae	mouse
Physopelta festiva	other insect
Pipistrelle bat	bat
Pipistrellus pipistrellus	bat
Pipistrellus pygmaeus	bat
Platymeris rhadamanthus	other insect
Platyrrhinus lineatus	bat
Potorous gilbertii	marsupial
Potos flavus	other mammal
Praomys daltoni	other rodent
Proboscidocoris fuliginosus	other insect
Procavia capensis (rock hyrax)	other mammal
Procyon lotor	raccoon
Proechimys iheringi	other rodent
Proechimys longicaudatus	other rodent
Promops sp.	bat
Psathyromyia dendrophyla	fly
Pseudobagras fulvidraco	other fish
Pseudoboa nigra	snake
Pteromys volans	squirrel
Pteronotus parnellii	bat
Quokka (Setonix brachyurus)	marsupial
Rattus rattus	rat
Rhabdadenia biflora	Plant
Rhinella margaritifer	toad
Rhipidura fuliginosa	other bird
Rhodnius brethesi	other insect
Rhodnius colombiensis	other insect
Rhodnius neglectus	other insect
Rhodnius pallescens	other insect
Rhodnius pictipes	other insect
Rhodnius prolixus	other insect
Rhodnius robustus	other insect
Rhodnius robustus II	other insect
Rhodnius sp.	other insect
Rhodnius stali	other insect
Rhombomys opimus	other rodent
Rhombomys opinus	other rodent
Rhynocoris albopilosus	other insect
Rhynocoris bicolor	other insect
Rhynocoris rapax	other insect
Rhynocoris sp.	other insect
Riptortus tenuicornis	other insect
Rousettus aegyptiacus	bat
Saguinus bicolor	monkey
Saguinus fuscicollis	monkey
Saguinus labiatus	monkey
Saguinus midas	monkey
Saimiri sciureus	monkey
Saimiri ustus	monkey
Salda littoralis	other insect
Saldula pallipes	other insect
Sarcophaga sp.	fly
Sarju taungyiana	other insect
Scardinus erythrophthalmus	other fish
Scinax hayii	frog
Scinax ruber	frog
Sciopemyia servulolimai	fly
Sciopemyia sordellii	fly
Sciopemyia sp.	fly
Sciurus spadiceus	squirrel
Sepontia nitens	other insect
Sergentomyia minuta	fly
Sericornis magnirostris	other bird
Setonix brachyurus	marsupial
Sitta europaea	other bird
Sphaerocoris cf. testudogrisea	fly
Sphaerocoris testudogrisea	fly
Sphedanolestes picturellus	other insect
Spilopsyllus cuniculi	other insect
Spilostethus pandurus	other insect
Stenozygum alienatum	other insect
Strepera sp.	other bird
Sturnira lilium	bat
Sylvia atricapilla	warbler
Syncerus caffer (buffalo)	buffalo
Tabanus sp.	fly
Tadarida sp.	bat
Talpa europea	other mammal
Tapirocoris cf. limbatus	other insect
Tarentola annularis	gecko
Tenagogonus albovittatus	other insect
Thyroptera tricolor	bat
Tinca tinca	other fish
Tonatia bidens	bat
Trachycephalus venulosus	frog
Tragelaphus spekii	antelope
Triatoma barberi	other insect
Triatoma dimidiata	other insect
Triatoma garciabesi	other insect
Triatoma guasayana	other insect
Triatoma infestans	other insect
Triatoma nitida	other insect
Triatoma pallidipennis	other insect
Triatoma rubrovaria	other insect
Triatoma sanguisuga	other insect
Triatoma spinolai	other insect
Trifolium glomeratum	Plant
Trigla lineata	other fish
Tsetse Glossina palpalis gambiensis	fly
Turdus migratorius	thrush
Turdus sp.	thrush
Uroderma bilobatum	bat
Viannamyia tuberculata	fly
Vombatus ursinus	marsupial
Vombatus ursinus AHB	marsupial
Wallabia bicolor	marsupial
Zelus leucogrammus	other insect
Zelus sp.	other insect
african toad	toad
badger, Meles meles	other mammal
bats	bat
bergamot	Plant
biting midge (Culicoides festivipennis)	other insect
black fly (Eusimulium securiforme)	fly
buffalo (B15)	buffalo
buffalo (B17)	buffalo
buffalo (B18)	buffalo
bullfrog	frog
coconut	Plant
crab-eating fox	fox
gecko Tarentola annularis	gecko
gerbil	other rodent
macaque, Macaca sp.	monkey
mammals and marsupials	Unknown
man	Mammals - human
maned-wolf	wolf
mango	Plant
monitor lizard	lizard
oil palm	Plant
rook 3.12.79	other bird
sand fly	fly
sandfly	fly
unidentified bug	other insect
vole Microtis agrestis	vole
Bunocephalus coracoideus	other fish
Clarias batrachus	other fish
Clarias macrocephalus x Clarias gariepinus	other fish
Corydoras leucomelas	other fish
Eleutherococcus gracilistylus	Unknown
Eleutherococcus senticosus	Unknown
Gnathonemus petersii	other fish
Oncorhynchus makkis	salmon
Oncorhynchus mykiss	salmon
Oncorhynchus mykkis	salmon
Salmo trutta fario	salmon
homo sapiens	Mammals - human
####	Unknown
#0#	Unknown
#[,#	Unknown
#\,#	Unknown
#o.#	Unknown
Acanthiza katherina	other bird
Accipiter soloensis	other bird
Accipiter striatus	other bird
Accipiter tachiro	other bird
Acridotheres tristis	other bird
Acrocephalus arundinaceus	warbler
Acrocephalus baeticatus	warbler
Acrocephalus gracilirostris	warbler
Acrocephalus mendanae	warbler
Acrocephalus orientalis	warbler
Acrocephalus schoenobaenus	warbler
Aedes albopictus	mosquito
Aedes esoensis with blood-meal of Cervus nippon yesoensis	mosquito
Aegithina tiphia	other bird
Aegolius acadicus	owl
Aegolius funereus	owl
Agama agama	lizard
Agamia agami	other bird
Agelaius icterocephalus	other bird
Agelaius phoeniceus	other bird
Ailuroedes melanotis	other bird
Ailuroedus melanotis	other bird
Alauda arvensis	other bird
Alcedo atthis	other bird
Alcippe morrisonia	other bird
Alethe diademata	thrush
Alethe diademata castanea	thrush
Alethe poliocephala	thrush
Alouatta seniculus	monkey
Amaurornis phoenicurus	other bird
Ameiva ameiva	lizard
Ammodramus humeralis	sparrow
Andropadus gracilis	bulbul
Andropadus latirostris	bulbul
Andropadus virens	bulbul
Anolis chloris (wild lizard)	lizard
Anolis oculatus	lizard
Anopheles hackeri	mosquito
Anopheles moucheti	mosquito
Anopheles vinckei	mosquito
Anthornis melanura	other bird
Anthreptes platurus	other bird
Anthreptes seimundi	other bird
Anthus berthelotii	other bird
Anthus hodgsoni	other bird
Anthus trivialis	other bird
Antilophia galeata	other bird
Aphelocoma californica	other bird
Aphrastura spinicauda	other bird
Aplonis atrifusca	other bird
Aplonis tabuensis	other bird
Aptenodytes patagonicus	penguin
Apteryx haastii	other bird
Aquila chrysaetos (golden eagles)	eagle
Ara nobilis	other bird
Aramides ypecaha	other bird
Aratinga aurea	other bird
Ardea alba	other bird
Ardea herodias	other bird
Asio otus	owl
Atheruri africanus	porcupine
Atherurus africanus	porcupine
Automolus ochrolaemus	other bird
Aythya marila	other bird
Baelophus bicolor	other bird
Baeolophus bicolor	other bird
Basileuterus flaveolus	warbler
Basileuterus hypoleucus	warbler
Bleda eximia notata	bulbul
Bleda notata	bulbul
Bleda syndactyla	bulbul
Bubo virginianus	owl
Buteo jamaicensis	hawk
Butorides striatus	other bird
Cacicus cela	other bird
Calidris melanotos	other bird
Callaeas cinerea	other bird
Callaeas cinerea wilsoni	other bird
Calonectris leucomelas	other bird
Camaroptera brachyura	other bird
Campethera nivosa	other bird
Camptostoma obsoletum	other bird
Campylorhynchus yucatanicus	other bird
Cantorchilus leucotis	other bird
Cardinalis phoeniceus	other bird
Carduelis carduelis	finch
Carduelis chloris	finch
Carpodacus erythrinus	finch
Carpodacus mexicanus	finch
Catharus aurantiirostris	thrush
Catharus ustulatus	thrush
Catharus ustulatus (Swainson's thrush)	thrush
Cercomela fusca	other bird
Cercopithecus cephus	monkey
Cercotrichas galactotes	other bird
Cercotrichas podobe	other bird
Cettia cetti	warbler
Chalcomitra rubescens	other bird
Chalcophaps indica	dove
Chamaeza campanisona	other bird
Chasiempis sandwichensis	other bird
Cicinnurus regius (king bird-of-paradise)	other bird
Cinclidium leucurum	other bird
Cinclocerthia ruficauda	other bird
Cinnyris chloropygius	other bird
Cinnyris coquerellii	other bird
Cinnyris dussumieri	other bird
Cinnyris preussi	other bird
Cinnyris sovimanga	other bird
Circus aeruginosus	other bird
Cisticola anonymus	warbler
Cisticola fulvicapillus	warbler
Cnemotriccus fuscatus	other bird
Coereba flaveola	other bird
Colinus virginianus ridgwayi (masked bobwhite quail)	quail
Colluricincla boweri	other bird
Columbina cruziana	dove
Conopophaga lineata	other bird
Conopophaga melanops	other bird
Copsychus luzoniensis	other bird
Copsychus malabaricus	thrush
Copsychus saularis	thrush
Coquillettidia aurites	mosquito
Coquillettidia pseudoconopas	mosquito
Coquillettidia spp.	mosquito
Corvus corax (common raven)	crow
Corvus corone	crow
Corvus macrorhynchos	crow
Coryphospingus pileatus	finch
Cossypha natalensis	other bird
Cossypha niveicapilla	other bird
Coturnix coturnix	other bird
Cracticus quoyi	other bird
Crateroscelis murina	warbler
Crateroscelis robusta	warbler
Criniger calurus	bulbul
Criniger chloronotus	bulbul
Culex annulioris	mosquito
Culex fuscanus	mosquito
Culex guiarti	mosquito
Culex modestus	mosquito
Culex neavei	mosquito
Culex nigropunctatus	mosquito
Culex perexiguus	mosquito
Culex perfidiosus	mosquito
Culex pipiens (mosquito)	mosquito
Culex pipiens group	mosquito
Culex pipiens pallens	mosquito
Culex pipiens quinquefasciatus	mosquito
Culex poicilipes	mosquito
Culex restuans	mosquito
Culex sasai with blood-meal of Corvus macrorhynchos	mosquito
Culex sasai with blood-meal of Parus major	mosquito
Culex sasai with blood-meal of Turdus pallidus	thrush
Culex sp. (mosquito)	mosquito
Culex theileri (mosquito)	mosquito
Culex vorax	mosquito
Culicoides festivipennis	other insect
Culicoides kibunensis	other insect
Culicoides pictipennis	other insect
Culicoides simulator	other insect
Culiseta annulata (mosquito)	mosquito
Cyanistes caeruleus	other bird
Cyanocompsa cyanoides	other bird
Cyanomitra cyanolaema	other bird
Cyanomitra obscura	other bird
Cyanomitra oritis	other bird
Cyanomitra verticalis	other bird
Cygnus columbianus (tundra swan)	swan
Cypsnagra hirundinacea	other bird
Deleornis fraseri	other bird
Delichon urbica	other bird
Dendrocincla turdina	other bird
Dendroica coronata	warbler
Dendroica discolor	warbler
Dendroica magnolia	warbler
Dendroica pensylvanica	warbler
Dendroica petechia	warbler
Dicrurus adsimilis	other bird
Dicrurus adsimilis coracinus	other bird
Dinemellia dinemelli	other bird
Dumetella carolinensis	other bird
Egernia stokesii	other reptile
Elaenia albiceps	other bird
Elaenia chiriquensis	other bird
Elaenia cristata	other bird
Elenia martinica	other bird
Emberiza hortulana	other bird
Emberiza rutila	other bird
Emberiza spodocephala	other bird
Emberizoides herbicola	finch
Embernagra platensis	finch
Emoia longicauda	other reptile
Erithacus komadori	other bird
Estrilda astrild	finch
Eudyptes chrysocome	penguin
Eudyptes chrysocome (from zoo)	penguin
Eudyptes chrysolophus	penguin
Eudyptula minor	penguin
Eulecestoma nigripectus	other bird
Euneornis campestris	other bird
Euphonia chlorotica	other bird
Euphonia violacea	other bird
Euplectes orix	other bird
Falco naumanni	falcon
Formicarius colma	other bird
Formicivora grisea	other bird
Formicivora melanogaster	other bird
Formicivora serrana	other bird
Foudia eminentissima	other bird
Foudia flavicans	other bird
Foudia madagascarensis	other bird
Foudia madagascariensis	other bird
Foudia seychellarum	other bird
Foulehaio carunculata	other bird
Fraseria cinerascens	other bird
Furnarius rufus	other bird
Galbula ruficauda	other bird
Garrulus glandarius	other bird
Geococcyx californianus (greater roadrunner)	other bird
Geothlypis trichas	warbler
Geothylpis trichas	warbler
Geotrygon montana	dove
Gnorimopsar chopi	other bird
Grus nigricollis	crane
Gyps bengalensis	vulture
Halcyon chloris	other bird
Haliaeetus vocifer	eagle
Hedydipna collaris	other bird
Helmitheros vermivorus	warbler
Hemignathus flavus	finch
Hemignathus virens	finch
Hemiphaga novaeseelandiae	other bird
Hemithraupis guira	other bird
Himatione sanguinea	other bird
Hippolais pallida	warbler
Homo sapiens, blood	Mammals - human
Humblotia flavirostris	other bird
Hydrochaeris hydrochaeris	rodent
Hylia prasina	warbler
Hylocichla mustelina	thrush
Hylocryptus rectirostris	other bird
Hylophilus pectoralis	other bird
Hypothymis azurrea	other bird
Hypsilurus modestus	lizard
Hypsipetes amaurotis	bulbul
Hypsipetes madagascariensis	bulbul
Hypsipetes philippinus	bulbul
Icteria virens	other bird
Icteria virens (SL-18)	other bird
Icterus cayanensis	other bird
Icterus nigrogularis	other bird
Ilicura militaris	other bird
Illadopsis cleaveri	other bird
Illadopsis rufipennis	other bird
Ixobrychus flavicollis	other bird
Ixobrychus minutus	other bird
Lalage leucomela	other bird
Lamprotornis purpureiceps	other bird
Lamprotornis splendidus	other bird
Lanius cristatus	other bird
Larosterna inca	other bird
Lepidothrix coronata	other bird
Leptocoma sericea (black sunbird)	other bird
Leptopogon amaurocephalus	other bird
Leptotila verreauxi	dove
Lichenostomus frenatus	other bird
Lichenostomus versicolor	other bird
Linurgus olivaceus	finch
Locustella fasciolata	warbler
Lonchura malacca	finch
Lonchura punctulata	finch
Loxia curvirostra	finch
Loxigilla noctis	finch
Loxigilla violacea	finch
Luscina svecica	other bird
Luscinia megarhynchos	other bird
Luscinia svecica	other bird
Luscinia svecica azuricollis	other bird
Macaca cyclopis	monkey
Malacoptila striata	other bird
Malimbus nitens	other bird
Mandrillus sphinx	monkey
Mansonia uniformis	mosquito
Margarops fuscus	other bird
Megalurus palustris	warbler
Meliphaga analoga	other bird
Meliphaga aruensis (puff-backed honeyeater)	other bird
Melospiza melodia	sparrow
Merops malimbicus	other bird
Milvus migrans	kite
Milvus spp.	kite
Mimus gilvus	other bird
Mimus saturninus	other bird
Mniotilta varia	warbler
Molothrus bonariensis	other bird
Monarcha kaupi	other bird
Monarcha trivirgatus	other bird
Monasa nigrifrons	other bird
Motacilla alba	other bird
Motacilla flava	other bird
Muscicapa olivascens	other bird
Muscicapa striata	other bird
Myiagra alecto	other bird
Myiarchus swainsoni	other bird
Myiarchus tyrannulus	other bird
Myiopagis caniceps	other bird
Myzomela cardinalis	other bird
Nectarinia aspasia	other bird
Nectarinia coquereli	other bird
Nectarinia humbloti	other bird
Nectarinia notata	other bird
Nectarinia olivacea	other bird
Neochmia temporalis	finch
Neocossyphus fraseri	thrush
Neocossyphus poensis	thrush
Neocossyphus rufus	thrush
Neothraupis fasciata	other bird
Nicator chloris	other bird
Niltava sundara	other bird
Ninox philippensis	owl
Ninox scutulata	owl
Norops cupreus	lizard
Notiomystis cincta	other bird
Ochlerotatus caspius	mosquito
Oriolus brachyrhynchus	other bird
Orthotomus cuculatus	warbler
Pachyptila belcheri	other bird
Pachyramphus polychopterus	other bird
Pan troglodytes troglodytes isolate Shegue	chimpanzee
Paradoxornis webbianus	other bird
Parisoma subcaeruleum	warbler
Parula americana	warbler
Parus major	other bird
Parus palustris	other bird
Passer domensticus	sparrow
Passer domesticus (house sparrow)	sparrow
Passer luteus	sparrow
Passer luteus lutens	sparrow
Passer melanurus	sparrow
Passerina cyanea	other bird
Penelopides panini	other bird
Phaeomyias murina	other bird
Phasianus colchicus	other bird
Phrygilus patagonicus	other bird
Phyllastrephus icterinus	other bird
Phylloscopus trochilus	warbler
Pipra fasciicauda	other bird
Piranga olivacea	other bird
Piranga olivacea (OZ99-082)	other bird
Pitohui dichrous	other bird
Pitohui incertus	other bird
Pitta versicolor	other bird
Platysteira castanea	other bird
Ploceus cucullatus	weaver
Ploceus grandis	weaver
Ploceus intermedius	weaver
Ploceus melanogaster	weaver
Ploceus nigerrimus	weaver
Ploceus nigricollis	weaver
Ploceus princeps	weaver
Ploceus velatus	weaver
Ploceus xanthops	weaver
Pluvialis fulva	other bird
Pomatorhinus ferruginosus	other bird
Pongo pygmaeus (orangutan)	orangutan
Poospiza lateralis	finch
Praomys tullbergi	mouse
Prasinohaema prehensicauda	lizard
Pseudhirundo griseopyga	other bird
Pseudoalcippe abyssinica	other bird
Pseudoleistes guirahuro	other bird
Pseudoleistes virescens	other bird
Ptilinopus porphyraceus	dove
Ptilorrhoa caerulescens (blue jewel-babbler)	other bird
Pycnonotus barbatus	bulbul
Pyrenestes ostrinus	finch
Pyriglena leucoptera	other bird
Pytilia melba	finch
Quelea quelea	other bird
Quiscalus quiscula	other bird
Ramphocelus carbo	other bird
Rhinomyias albigularis	other bird
Rhipidura rufifrons	other bird
Saimiri peruviensis	monkey
Saltator atricollis	other bird
Saltator coerulescens	other bird
Saltator maximus	other bird
Scaphidura oryzivorus	other bird
Sceloporus jarrovi	lizard
Sceloporus mexicanum	lizard
Sceloporus occidentalis	lizard
Scenopoeetes dentirostris	other bird
Seiurus aurocapilla	warbler
Seiurus aurocapillus	warbler
Seiurus noveboracensis	warbler
Serinus atrogularis	finch
Sialia mexicana	thrush
Sittiparus varius	other bird
Spermophaga haematina	finch
Spheniscidae	penguin
Spheniscus demersus	penguin
Spheniscus demursus	penguin
Spheniscus humboldti	penguin
Spheniscus humboldti (from zoo)	penguin
Spheniscus magellanicus	penguin
Spheniscus mendiculus	penguin
Sphenomorphus jobiensis	lizard
Sphenomorphus simus	lizard
Spizella passerina	sparrow
Stachyris pyrrhops	other bird
Stephanophorus diadematus	other bird
Stiphrornis erythrothorax	other bird
Streptopelia orientalis	dove
Streptoprocne zonaris	other bird
Strix occidentalis caurina	owl
Strix varia	owl
Sturnella militaris	other bird
Sturnella superciliaris	other bird
Sturnella supercilliaris	other bird
Sturnis vulgaris (starling)	other bird
Sturnus unicolor	other bird
Sublegatus arenarum	other bird
Suiriri islerorum	other bird
Sula capensis	other bird
Sylvia borin	warbler
Symposiachrus trivirgatus (spectacled monarch)	other bird
Tachycineta bicolor	other bird
Tachyphonus luctuosus	other bird
Tachyphonus rufus	other bird
Tangara icterocephala	other bird
Tangara preciosa	other bird
Tarsiger cyanurus	other bird
Terpsiphone rufiventer	other bird
Thamnophilus ambiguus	other bird
Thamnophilus caerulescens	other bird
Thraupis sayaca	other bird
Thryomanes bewickii	other bird
Thryothorus ludovicianus	other bird
Tiaris bicolor	finch
Tiaris fuliginosus	finch
Tockus flavirostris	other bird
Todiramphus chloris (collared kingfisher)	other bird
Tolmomyias flaviventris	other bird
Trichothraupis melanops	other bird
Tringa nebularia	other bird
Troglodytes aedon	wren
Troglodytes musculus	wren
Troglodytes troglodytes	wren
Turdoides jardineii	other bird
Turdus amaurochalinus	thrush
Turdus assimilis	thrush
Turdus aurantius	thrush
Turdus falcklandii	thrush
Turdus fumigatus	thrush
Turdus leucomelas	thrush
Turdus merula (blackbird)	thrush
Turdus pallidus	thrush
Turdus pelios	thrush
Turdus philomelos	thrush
Turdus philomelos (song thrush)	thrush
Turdus plumbeus	thrush
Turdus rufiventris	thrush
Turtur afer	dove
Tympanuchus cupido	chicken
Uraeginthus bengalus	finch
Vestiaria coccinea	other bird
Vireo altiloquus	other bird
Vireo griseus	other bird
Vireo olivaceus	other bird
Vireo solitarius	other bird
Volatinia jacarina	sparrow
Xanthotis flaviventer	other bird
Xiphorhynchus picus	other bird
Zenaida aurita	dove
Zenaida macroura	dove
Zenaida meloda	dove
Zeneida macroura	dove
Zonotrichia albicollis	sparrow
Zonotrichia capensis	sparrow
Zonotrichia leucophrys	sparrow
Zoothera cameronensis	thrush
Zoothera dauma	thrush
Zosterops borbonicus	other bird
Zosterops borbonicus mauritianus	other bird
Zosterops choloronothos	other bird
Zosterops flavifrons	other bird
Zosterops griseotinctus (Louisiade white-eye)	other bird
Zosterops lateralis	other bird
Zosterops maderaspatanus	other bird
Zosterops maderaspatanus kirki	other bird
Zosterops mayottensis mayottensis	other bird
Zosterops mouroniensis	other bird
Zosterops senegalensis	other bird
Zosterops xanthochrous	other bird
`:4#	Unknown
`[,#	Unknown
leaf monkey	monkey
saimiri	monkey
Acalymma vittatum	beetle
Blaberus discoidalis	other insect
Blattella germanica	other insect
Bufo bufo	toad
California towhee (Pipilo crissalis)	other bird
Canary (Serinus canaria)	other bird
Canis lupus dingo	wolf
Cavia porcellus (guinea pig)	guinea pig
Chinese collared finchbill (Spizixos semitorques semitorques)	other bird
Columba palumbus (wood pigeon)	dove
Costa rican orange-billed sparrow (Arremon aurantiirostris rufidorsalis)	sparrow
Cowbird (Molothrus ater)	other bird
Diabrotica undecimpunctata	beetle
Eastern blue-winged sivia (Minla cyanouroptera cyanouroptera)	other bird
Eastern golden-breasted starling (Cosmopsarus regius magnificus)	other bird
Eastern white-starred bush robin (Pogonocichla stellata orientalis)	other bird
Emerald starling (Lamprotornis iris)	other bird
Grosbeak starling (Scissirostrum dubium)	other bird
Gryllus pennsylvanicus	other insect
Guianan turquoise tanager (Tangara mexicana mexicana)	other bird
Gulo gulo (wolverine)	other mammal
Himalayan grey-headed bullfinch (Pyrrhula erythaca erythaca)	other bird
Iranian native goat	goat
Javan ruby-throated bulbul (Pycnonotus melanicterus dispar)	bulbul
Malpolon monspessulanus	snake
Melanoplus differentialis	other insect
Meles meles	other mammal
Morelia viridis	snake
Mustela furo	other mammal
Northern blue dacnis (Dacnis cayana ultramarina)	other bird
Northern house sparrow (Passer domesticus domesticus)	sparrow
Northern white-headed buffalo weaver (Dinemellia dinemelli dinemelli)	other bird
Pelophylax esculentus	frog
Psammophis schokari	snake
Rana dalmatina	frog
Reichenow's weaver (Ploceus baglafecht reichenowi)	other bird
Sichuan white-browed laughing thrush (Garrulax sannio oblectans)	thrush
Southern cape sparrow (Passer melanurus melanurus)	sparrow
Surinam crested oropendola (Psarocolius decumanus decumanus)	other bird
Tenebrio molitor	beetle
Tribolium castaneum	beetle
Tribolium freemani	beetle
Ursus arctos (brown bear)	bear
Vostox brunneipennis	other insect
Vulpes lagopus	fox
Wattled starling (Creatophora cinerea)	other bird
dog (Golden Retriever)	dog
dog (Rottweiler)	dog
dog breed Golden Retriever	dog
dog breed Rottweiler	dog
grizzly bear	bear
Antilope cervicapra (Indian Blackbuck)	gazelle
Apodemus chevrieri	mouse
Axis axis (Indian spotted deer)	deer
Bos gaurus (Indian Gaur)	cow
Bos taurus (cattle no. 06)	cow
Bos taurus (cattle no. 101)	cow
Bos taurus (cattle no. 12)	cow
Bos taurus (cattle no. 122)	cow
Bos taurus (cattle no. 123)	cow
Bos taurus (cattle no. 13)	cow
Bos taurus (cattle no. 14)	cow
Bos taurus (cattle no. 141)	cow
Bos taurus (cattle no. 142)	cow
Bos taurus (cattle no. 152)	cow
Bos taurus (cattle no. 157)	cow
Bos taurus (cattle no. 21)	cow
Bos taurus (cattle no. 22)	cow
Bos taurus (cattle no. 24)	cow
Bos taurus (cattle no. 25)	cow
Bos taurus (cattle no. 27)	cow
Bos taurus (cattle no. 37)	cow
Bos taurus (cattle no. 39)	cow
Bos taurus (cattle no. 40)	cow
Bos taurus (cattle no. 49)	cow
Bos taurus (cattle no. 50)	cow
Bos taurus (cattle no. 57)	cow
Bos taurus (cattle no. 63)	cow
Bos taurus (cattle no. 64)	cow
Bos taurus (cattle no. 65)	cow
Bos taurus (cattle no. 7)	cow
Bos taurus (cattle no. 74)	cow
Bos taurus (cattle no. 8)	cow
Bos taurus (cattle no. 86)	cow
Bos taurus (cattle no. 87)	cow
Bos taurus (cattle no. 9)	cow
Bos taurus (cattle no. 93)	cow
Bos taurus (cattle no. 97)	cow
Bos taurus bleed Holstein	cow
Bos taurus cattle no.136	cow
Bos taurus cattle no.192	cow
Bos taurus cattle no.198	cow
Bos taurus cattle no.40	cow
Bos taurus cattle no.52	cow
Bos taurus cattle no.72	cow
Boselaphus tragocamelus (Nilgai)	antelope
Bubalus bubalis (Buffalo no. 17)	buffalo
Canis lupus familiaris breed German Shepherd	dog
Canis lupus familiaris breed Malinois	dog
Capra hircus (Goat no. 11)	goat
Cervus elaphus canadensis (elk)	elk
Cervus unicolor (Sambar deer)	deer
Damaliscus lunatus	antelope
Equus asinus africanus	donkey
Equus grevyi	zebra
German shepherd dog	dog
Haemaphysalis longicornis	Unknown
Homo sapiens with recent exposure in Long Island, USA	Mammals - human
Hyalomma anatolicum	Unknown
Hyalomma excavatum	Unknown
Ixodes canisuga	Unknown
Ixodes hexagonus	Unknown
Ixodes ricinus (tick from bird)	other bird
Ixodes ricinus (tick); nymph	Unknown
Mus pahari	mouse
Neovison vison blood	other mammal
Ozotoceros bezoarticus (pampa-deer)	deer
Rattus losea	rat
Rhinoceros unicornis (Indian rhinoceros)	rhinoceros
Rucervus duvaucelii (Barasingha)	deer
Sigmodon hispidus	rat
Talpa europaea	other mammal
Tetracerus quadricornis (Chousingha)	antelope
free-ranging bighorn sheep (Ovis canadensis nelsoni)	sheep
labrador dog	dog
naturally infected sheep	sheep
pit bull terrier	dog
white-lipped deer	deer
Antheraea pernyi	moth
Antheraea pernyi Guerin-Meneville	moth
Apis mellifera | Merops apiaster	bee
Bombus hortorum	bee
Bombus sichellii	bee
Bombus trifasciatus	bee
Cnaphalocrocis medinalis	moth
Empoasca fabae	other insect
Euproctis chrysorrhoea	moth
Gammarus duebeni	Crustacean
Lymantria dispar	moth
Penaeus monodon	Crustacean
Penaeus vannamei	Crustacean
Psithyrus rupestris	bee
Solenopsis cf. geminata	ant
Solenopsis geminata	ant
Solenopsis geminata X S. xyloni hybrid	ant
Solenopsis invicta	ant
Trichoplusia ni	moth
Tyria jacobaeae	moth
Aselliscus stoliczkanus	bat
Boa constrictor imperator	snake
Bubalus bubalis, calf	buffalo
Cystophora cristata	seal
Duttaphrynus melanostictus (Doubtful toad)	toad
Gerres oblongus (silver biddy)	other fish
Hipposideros pomona	bat
Homo sapiens; female	Mammals - human
Leptonychotes weddellii (Weddell seal)	seal
Mirounga leonina (Southern elephant seal)	seal
Pagophilus groenlandicus	seal
Phalacrocorax sp.	other bird
Pogona vitticep	lizard
Qinchuan cattle	cow
Rattus rattus (wild black rat)	rat
Rattus tanezumi	rat
Rhinolophus sinicus	bat
Rousettus leschenaultii	bat
Siberian chipmunk	other rodent
Siberian hamster	other rodent
animal	Unknown
bamboo rat	rat
buffalo; female	buffalo
cattle; female	cow
cattle; male	cow
cobra	snake
cow, breed Holstein Friesian	cow
foal	horse
gold gourami	other fish
golden hamster	other rodent
goldfish	other fish
neon tetra	other fish
patient	Unknown
red eye tetra	other fish
Alouatta caraya (black howler monkey)	monkey
Alouatta fusca (brown howler monkey)	monkey
Ateles belzebuth (white-fronted spider monkey)	monkey
Atlantic cod (Gadus morhua)	other fish
Bos primigenius indicus	cow
Canis lupus (wolf)	wolf
Gorilla beringei beringei	gorilla
Mus musculus domesticus	mouse
Onchorhyncus tshawytscha	salmon
Planigale maculata	other marsupial
Pseudomys albocinereus	mouse
Rattus fuscipes	rat
Sus scrofa (wild boar or wild pig)	pig
Thomson's gazelle	gazelle
Vicugna pacos; age: adult; apparently healthy female	alpaca
Vicugna pacos; age: neonate; apparently healthy female	alpaca
Vicugna pacos; age: neonate; apparently healthy male	alpaca
Vicugna pacos; age: neonate; sick female	alpaca
Vicugna pacos; age: neonate; sick male	alpaca
ide (Leuciscus idus)	other fish
oyster (Ostrea edulis)	oyster
turkey (Meleagris gallopavo)	turkey
Solea senegalensis	other fish
injured dog	dog
Lophius litulon	other fish
Seriola quinqueradiata	other fish
Acomys dimidiatus	mouse
Acomys sp.	mouse
Bear	bear
Bear, Alaska Black 	bear
Bear, Black	bear
Bear, Brown	bear
Bobcat	cats
Capybara	other rodent
Chicken	chicken
Cow	cow
Coyote	coyote
Crow, Hawaiian	crow
Deer, White-Tailed	deer
Dog	dog
Dog?	dog
Dolphin, Bottlenose	dolphin
Dolphin, Striped	dolphin
Dove	dove
Eagle, Bald	eagle
Fox, Arctic	fox
Fox, Red	fox
Gerbillus dasyurus	other rodent
Goat	goat
Goose	goose
Guinea Fowl	other bird
Hawk, Ferruginous	hawk
Hawk, Red-Tailed	hawk
Hawk, Rough-Legged	hawk
Hawk, Swainson's	hawk
Hawk, Swainson's 	hawk
Heliophobius argenteocinereus	rat
Human congenital	Mammals - human
Jaguar	jaguar
Jaguarundi	cats
Kestrel, American	falcon
Lagidium viscacia	other rodent
Lemmus trimucronatus	other rodent
Monkey	monkey
Monkey, Red-Handed Howler 	monkey
Moue, White-Footed	mouse
Mouse	mouse
Ochotona hyperborea	other mammal
Opossum	possum
Opposum, Black-Eared 	possum
Owl, Barn	owl
Phataginus tricuspis	other mammal
Pigeon	dove
Rabbit	rabbit
Rat	rat
Rat, Wood	rat
Rodent	other rodent
Sand Cat	cat
Sea Otter	otter
Setonix brachyurus (quokka)	other marsupial
Skunk	skunk
Skunk, Striped	skunk
Sparrow, Tree	sparrow
Spermophilus citellus	squirrel
Spermophilus elegans	squirrel
Starling, European	other bird
Turkey	turkey
Wallaby	wallaby
Wolf	wolf
human congenital 	Mammals - human
Montipora digitata	Unknown
Accipiter fasciatus	other bird
American goldfinch	other bird
Anas formosa	duck
Anguis fragilis	other reptile
Bison bonasus	bison
Bombina bombina	toad
Bubalus depressicornis	water buffalo
Chersina angulata	tortoise
Colobus angolensis	monkey
Columbina passerina	dove
Cooper's hawk	hawk
Cygnus olor	swan
Geochelone carbonaria	tortoise
Geochelone elegans	tortoise
Geochelone nigra	tortoise
Geochelone radiata	tortoise
Hemiphaga novaeseelandiae (New Zealand pigeon)	other bird
Hieraaetus fasciatus	eagle
Hieraaetus pennatus	eagle
Hylobates syndactylus	other mammal
Indotestudo elongata	tortoise
Kinixys belliana nogueyi	tortoise
Limacus flavus (yellow cellar slug)	other mollusk
Limax maximus	other mollusk
Loxodonta africana	other mammal
Macaca nigra	monkey
Macaca silenus	monkey
Macroclemys temminckii	other reptile
Mauritian columbids	other bird
Myrmecophaga tridactyla (giant anteater)	other mammal
Numida meleagris	other bird
Patagioenas fasciata monilis	dove
Pecari tajacu	other mammal
Phacochoerus aethiopicus	pig
Phlegmariurus phlegmaria	Plant
Pleurodeles waltl	newt
Sus scrofa f. domestica	pig
Syncerus caffer caffer	buffalo
Syncerus caffer nanus	buffalo
Tayassu pecari	other mammal
Testudo graeca	tortoise
Testudo horsfieldii	tortoise
Tyto alba	owl
Varecia variegata	lemur
bald eagle	eagle
blue pigeon	dove
budgerigar	other bird
chaffinch	other bird
common ground dove	dove
estudo graeca	tortoise
green finch	finch
greenfinch	finch
racing pigeon	dove
rock pigeon	dove
scops owl	owl
sparrowhawk	other bird
turtle dove	dove
unidentified bird	Unknown
unknown	Unknown
white winged dove	dove
wood pigeon	dove
zebra dove	dove
Acrocephalus scirpaceus	warbler
Alopochen aegyptiacus	goose
Alouatta puruensis	monkey
Anolis distichus	lizard
Anopheles cracens	mosquito
Anopheles gabonensis	mosquito
Aotus nigriceps	monkey
Ateles chamek	monkey
Callicebus brunneus	monkey
Callicebus caligatus	monkey
Callicebus dubius	monkey
Carduelis spinus	finch
Chiropotes albinasus	monkey
Culex pipiens pipiens f. molestus	mosquito
Homo sapiens; Chinese malaria patient SJ in West Africa	Mammals - human
Homo sapiens; Chinese malaria patient ZJP in West Africa	Mammals - human
Homo sapiens; male	Mammals - human
Lagothrix cana cana	monkey
Mycteria americana	other bird
Oporornis formosus	warbler
Pan troglodytes elliote	chimpanzee
Pan troglodytes ellioti	chimpanzee
Pithecia irrorata	monkey
Saimiri sciureus peruviensis	monkey
Sapajus apella	monkey
Spinus spinus	finch
Troglodytes aedon MSB:Bird:31835; tissue voucher: NK163507	wren
Troglodytes aedon MSB:Bird:33844; tissue voucher: NK169070	wren
Troglodytes aedon MSB:Bird:34295; tissue voucher: NK171021	wren
Troglodytes aedon MSB:Bird:34739; tissue voucher: NK171465	wren
Troglodytes aedon MSB:Bird:34763; tissue voucher: NK171489	wren
Troglodytes aedon MSB:Bird:35442; tissue voucher: NK172168	wren
Troglodytes aedon MSB:Bird:35476; tissue voucher: NK172202	wren
Troglodytes aedon MSB:Bird:35493; tissue voucher: NK172219	wren
Troglodytes aedon MSB:Bird:35507; tissue voucher: NK172233	wren
Troglodytes aedon MSB:Bird:35512; tissue voucher: NK172238	wren
Turdus fuscater	thrush
Acritochaeta orientalis	fly
Alydinae sp.	other insect
Anthomyiidae sp.	fly
Aquarius paludum paludum	other insect
Bison bonasus bonasus	bison
Chaetopsylla globiceps	other insect
Chaetopsylla sp.	other insect
Coendou sp.	porcupine
Coenosia albicornis	fly
Coenosia tigrina	fly
Drosophila aff. immigrans	fly
Drosophila ananassae	fly
Drosophila elegans	fly
Drosophila falleni	fly
Drosophila immigrans	fly
Drosophila malerkotliana	fly
Drosophila neotestacea	fly
Drosophila sp.	fly
Drosophila takahashii	fly
Drosophilidae sp.	fly
Glossina morsitans ssp	fly
Glossina morsitans submorsitans	fly
Hipposideros caffer	bat
Homo sapiens; VL patient	Mammals - human
Hydrochoerus hydrochaeris	other rodent
Licaopex griseus	fox
Lophostoma brasiliense	bat
Lucilia caesar	fly
Meriones libycus	other rodent
Microdrosophila sp.	fly
Monopsyllus sciurorum	other insect
Musca sp.	fly
Onesia austriaca	fly
Ornithorhynchus anatinus (platypus)	platypus
Phlebotomus longicuspis	fly
Phlebotomus sergenti; female	fly
Ravinia sp.	fly
Rhinolophus landeri	bat
Rhipicephalus sanguineus; male	Unknown
Sarcophagidae sp.	fly
Sarcophaginae sp.	fly
Scaptodrosophila hibisci	fly
Sergentomyia gemmea	fly
Sergentomyia hamoni	fly
Sergentomyia ingrami	fly
Sergentomyia ingrami isolate HLE-22	fly
Sergentomyia ingrami isolate HLE-9	fly
Sergentomyia ingrami isolate KLE-2	fly
Trachops cirrhosus	bat
Wohlfahrtia nuba species group	fly
dog domestic	dog
unidentified leech collected from a Ornithorhynchus anatinus (platypus)	platypus
unidentified leech collected from a Platypus (Ornithorhynchus anatinus)	platypus
unknown fly species from f. Muscidae	fly
Leontopithecus chrysomelas (golden headed lion tamarin)	monkey
Trachypithecus auratus auratus (Eastern Javan langur)	monkey
horse; thoroughbred mare	horse
Caridina formosae	shrimp
Chironomus plumosus	fly
Halesus digitatus	caddisfly
Micropterna sequax	fly
Agelaius phoenicius	red-winged blackbird
Aix sponsa	duck
Anas acuta	duck
Anas americana	duck
Anas clypeata	duck
Anas crecca	duck
Anas cyanoptera	duck
Anas discors	duck
Anas penelope	duck
Anas platyrhynchus	duck
Anisus vortex	snail
Ardea cinerea	heron
Aythya affinis	duck
Aythya collaris	duck
Aythya fuligula	duck
Aythya valisineria	duck
Bandicota indica	rat
Bandicota indicum	rat
Batillaria australis	snail
Biompahalaria alexandrina	snail
Biompahalaria choanomphala	snail
Biompahalaria glabrata	snail
Biompahalaria pfeifferi	snail
Biompahalaria straminea	snail
Biompahalaria sudanica	snail
Biomphalaria alexandrina	snail
Biomphalaria cf. choanomphala	snail
Biomphalaria choanomphala choanomphala	snail
Biomphalaria choanomphala var. choanomphala	snail
Biomphalaria pfeifferi	snail
Biomphalaria sudanica	snail
Biomphalaria sudanica (snails)	snail
Biomphalaria tenagophila	snail
Bubalus sp.	water buffalo
Bucephala albeola	duck
Bulinus globosus	snail
Bulinus nyassanus	snail
Bulinus sp.	snail
Bulinus truncatus	snail
Chen caerulescens	goose
Chilina dombeiana	snail
Chilina fulgurata	snail
Chilina gibbosa	snail
Chilina neuquenensis	snail
Chilina parchappii	snail
Chilina perrieri	snail
Clangula hyemalis	duck
Crocodylus johnstoni	crocodile
Cygnus columbianus	swan
Elephas maximus	elephant
Grus grus	crane
Gyraulus parvus	snail
Haminoea japonica	snail
Homo sapiens; child #30	Unknown
Ilyanassa obsoleta	snail
Indoplanorbis exustus	snail
Larus delawarensis	gull
Larus delewarensis	gull
Lophodytes cucullatus	duck
Loxodonta cyclotis	elephant
Lymnaea stagnalis	snail
Lymnaea stagnalis isolate LSK2	snail
Lymnaea stagnalis isolate LSM1	snail
Lymnaea stagnalis isolate LSM2	snail
Lymnaea stagnalis isolate LSM20	snail
Lymnaea stagnalis isolate LSM3	snail
Lymnaea stagnalis isolate LSM4	snail
Lymnaea stagnalis isolate LSM7	snail
Melanoides sp.	snail
Melanoides tuberculata	snail
Melanoides tuberculata (snail)	snail
Mergus merganser	duck
Mergus serrator	duck
Neotomys sp.	mouse
Oncomelania	snail
Oncomelania hupensis	snail
Oncomelania hupensis hupensis	snail
Oncomelania hupensis robertsoni	snail
Papio cyanocephalus	other bird
Physa fontinalis	snail
Physa gyrina	snail
Physa marmorata	snail
Physa parkeri	snail
Planorbarius sp.	snail
Planorbis planorbis	snail
Radix ampla	snail
Radix auricularia	snail
Radix auricularia RAN77	snail
Radix auricularia RSBE1	snail
Radix auricularia RSBE13	snail
Radix auricularia RSBE2	snail
Radix auricularia RSBE67	snail
Radix auricularia RSFO1	snail
Radix auricularia RSFO3	snail
Radix auricularia RSFO4	snail
Radix auricularia RSST2	snail
Radix auricularia RSST3	snail
Radix auricularia RSST4	snail
Radix auricularia RSST5	snail
Radix auricularia RSST6	snail
Radix auricularia isolate RAM1	snail
Radix auricularia isolate RAM2	snail
Radix auricularia isolate RAM3	snail
Radix auricularia isolate RAM4	snail
Radix balthica	snail
Radix lagotis isolate ROM1	snail
Radix lagotis isolate ROM2	snail
Radix luteola	snail
Radix peregra	snail
Radix peregra DOU1	snail
Radix peregra ISF1	snail
Radix peregra ISF2	snail
Radix peregra ISF3	snail
Radix peregra ISF4	snail
Radix peregra ISF5	snail
Radix peregra ISF6	snail
Radix peregra RAN17	snail
Radix peregra RAN18	snail
Radix peregra RAN22	snail
Radix peregra RAN5	snail
Radix peregra RAN57	snail
Radix peregra RAN79	snail
Radix peregra RAN8	snail
Radix peregra RAN80	snail
Radix sp.	snail
Rhinoceros unicornis	snail
Stagnicola elrodi	snail
Stagnicola emarginata	snail
Stagnicola sp.	snail
Valvata macrostoma	snail
cashmere goat	goat
chimpanzee 'Sunday'	chimpanzee
chimpanzee (Sunday)	chimpanzee
infected Oncome lania hupensis	snail
Kalmia latifolia	Unknown
