Mexico: Union Roja	Mexico
Mexico: Francisco I. Madero	Mexico
Mexico: La Concordia	Mexico
Indonesia: Bali, Flores	Indonesia
China: Hainan	China
Zimbabwe	Zimbabwe
Brazil: Western Amazon Region	Brazil
India: Orissa	India
India: Dadri	India
Iran: Sistan and Baluchistan Province	Iran
Iran: Sistan and Baluchistan	Iran
India: Jabalpur	India
China: Hainan Province	China
Kenya: Asembo Bay	Kenya
Iran:Hormozgan	Iran
Iran: Pars-Abad district, Ardebil province	Iran
Iran: Fereydoonkenar district, Mazandaran province	Iran
India: Haryana	India
Thailand: Tak Province, Popphra District	Thailand
India: Darjeeling, West Bengal	India
Gabon: Bakoumba	Gabon
India: Car Nicobar	India
India:Uttaranchal	India
PNG	Papua New Guinea
other	Unknown
Mexico: Cd. Tapachula	Mexico
Mexico: 2a. Seccion de Izapa	Mexico
Mexico: Carrillo puerto Norte	Mexico
Mexico: Cacahoatan	Mexico
Mexico: La Toma	Mexico
India: Assam	India
Brazil: Maraba, Para	Brazil
India: Andaman and Nicobar Islands	India
India: Andaman and Nicobar	India
China: Anhui	China
Iran: Southeast	Iran
Indonesia: Maumere, Flores island	Indonesia
Gabon: Lambarene	Gabon
China: Hainan Island	China
Thailand: Trad Province, Borai District	Thailand
India:New Delhi	India
South Korea:Kyonggi-do	South Korea
Iran: Chabahar, Sistan and Baluchistan	Iran
Malaysia: Penang	Malaysia
India: Keonjhar, Orissa	India
Iran: Sistan Baluchestan	Iran
India:Nagaland	India
South Korea:Pajoo	South Korea
Italy:Teverina	Italy
Italy:Tuscany	Italy
Mexico: Canton San Francisco campamento	Mexico
Mexico: Finca San Antonio Nexapa	Mexico
Mexico: Fraccion La Ceiba	Mexico
Mexico: Rancheria Santa Rita	Mexico
Mexico: Mal Paso	Mexico
Mexico: Nueva Granada	Mexico
Mexico: Ejido Cozalapa-Benito Juarez	Mexico
India: Chennai	India
India: Jabalpur, Madhya Pradesh	India
Sri Lanka: Kataragama	Sri Lanka
Cote d' Ivoire	Ivory Coast
Myanmar: Pyin Oo Lwin Mandalay Division, central	Myanmar [Burma]
Democratic Republic of the Congo: Katanga	Democratic Republic of the Congo
Democratic Republic of the Congo:Katanga	Democratic Republic of the Congo
South Korea: Yeonchun-Goon, Kyonggi-Do	South Korea
Thailand:Mahidol	Thailand
Sri Lanka:Kataragama	Sri Lanka
China: Tengchong, Yunnan	China
China: Hainan, Ledong County	China
Papua New Guinea:Wosera	Papua New Guinea
Burma:Myanmar	Myanmar [Burma]
India:Punjab	India
Senegal:Thiess	Senegal
Mexico: Colonia 21 de marzo	Mexico
Mexico: 2a. Seccion de Medio Monte	Mexico
Mexico: Poste Rojo	Mexico
Mexico: Canton Horizonte	Mexico
China: Hainan province	China
Myanmar	Myanmar [Burma]
China: Tibet	China
Brazil: Itaituba, Para	Brazil
India: Kamrup, Assam	India
India: Madhya Pradesh	India
Iran: Southeast Iran	Iran
China: Ledong County, Hainan Province	China
Brazil: Rondonia	Brazil
China: Yunnan	China
Venezuela: Bolivar	Venezuela
Philippines: Palawan	Philippines
Iran: Konarak district, Sistan and Baluchistan province	Iran
Brazil: Rondonia, Ariquemes	Brazil
India: Himachal Pradesh	India
India: Ghaziabad, Uttar Pradesh	India
Indonesia: Halmahera island	Indonesia
Indonesia: Larantuka, Flores island	Indonesia
Indonesia: Laut island	Indonesia
Brazil: Mato Grosso	Brazil
Iran: Sistan and Bluchistan province, Chahbahar district	Iran
Viet nam	Vietnam
Thailand: Tak Province, Mae Sot District	Thailand
Brazil: Maracaja, Para	Brazil
Japan: Osaka	Japan
Iran: Mazanderan	Iran
Iran: Pars-Abad, Ardebil, North Iran	Iran
India:Ismailpur, Haridwar, Uttar Pradesh	India
Southeast Asia	asia
Senegal:Vellingara	Senegal
Mexico: Canton Porvenir	Mexico
Mexico: Fraccion Salvador Urbina	Mexico
Mexico: Benito Juarez	Mexico
Mexico: El Naranjo	Mexico
Mexico: Canton Sn Nicolas Lagartero	Mexico
Mexico: Ejido Conquista Campesina	Mexico
India: Raipur	India
India: Uttar Pradesh	India
China: Ruili City, Yunnan Province	China
Indonesia: Flores	Indonesia
Papua New Guinea: Bouganville	Papua New Guinea
Gambia: Farifenni	Gambia
Iran: Kahnouj, Kerman	Iran
Thailand: Bangkok	Thailand
Iran: Chabahar district, Sistan and Baluchistan province	Iran
India: Aligarh, Uttar Pradesh	India
Malaysia: Sabah	Malaysia
India: Orissa, Rourkela	India
China:Hainan province	China
Viet Nam: Khanh-Nam commune of the Khanh Hoa province	Vietnam
Thailand: Bangkok, King Chulalongkorn Memorial Hospital	Thailand
Brazil:Belem	Brazil
Indonesia:Irian Jaya	Indonesia
Iran: Sistan-Baluchistan	Iran
Papua New Guinea: Madang, Amele	Papua New Guinea
South Korea:Yonchon	South Korea
Iran: Kerman Province, Kahnouj, Southeast Iran	Iran
India: Andaman Island	India
India:Assam	India
India:Imphal, Manipur	India
Indochina/Laos	Indonesia
Mexico: Canton Montenegro	Mexico
Mexico: Chespal Viejo	Mexico
Mexico: 1a. Seccion de Guillen	Mexico
Mexico: 2a. Seccion Guillen	Mexico
Mexico: Alvaro Obregon	Mexico
India: Bangaluru	India
Afghanistan: Hirat	Afghanistan
Brazil: Porto Velho, Rondonia	Brazil
India: Sonapur	India
Indonesia: Papua	Indonesia
India: Navi Mumbai	India
China: Tengchong, Yunnan Province	China
Republic of the Congo: Brazzaville	Republic of the Congo
Iran: Pars-Abad, Ardabil	Iran
Iran: Iranshahr district, Sistan and Baluchistan province	Iran
India: Utter Pradesh	India
Iran: Sistan and Bluchistan province, Chabar district	Iran
South Korea: Seoul	South Korea
South Korea: Pajoo	South Korea
India: Sundergarh, Orissa	India
Brazil: Para	Brazil
Nigeria:Ibandan	Nigeria
Iran: Kahnouj, Ardebil	Iran
India:Ghaziabad,Uttar Pradesh	India
Papua New Guinea:Eastern Highlands Province	Papua New Guinea
Senegal:Pikine	Senegal
Mexico: Ejido Toluca	Mexico
Mexico: Plan las palmas	Mexico
Mexico: El manguito	Mexico
Mexico: Ejido Consejo Agrario	Mexico
Cote d'Ivoire	Ivory Coast
Indonesia: Irian Jaya province	Indonesia
Afghanistan: Nangarhar	Afghanistan
French Guiana	France
India: Nadiad	India
India: Rajasthan	India
India: Tamil Nadu	India
India: Goa	India
Venezuela: Amazonas	Venezuela
Iran: Hormozgan	Iran
Iran: Pars-Abad, Ardebil	Iran
China: Fujian	China
Indonesia: Buru island	Indonesia
El Salvador: La Paz	El Salvador
India: Sonapur, Assam	India
Iran: Bandar Abbas	Iran
Brazil: Manaus	Brazil
Iran: Chahbahar, Sistan and Baluchistan province	Iran
China: Ruili, Yunnan	China
India:Shankargarh,Uttar pradesh	India
India:Delhi	India
India:Morigaon nellei, Assam	India
Indochina	asia
Mexico: Ejido Santa Rita	Mexico
Mexico: Ejido Adolfo Lopez Mateos	Mexico
Mexico: Medio Monte	Mexico
Mexico: Canton Texcaltic	Mexico
Mexico: Ejido Carrillo puerto	Mexico
Mexico: Canton San Cristobal	Mexico
Viet Nam	Vietnam
India: Delhi	India
Brazil: City of Manaus, Amazonas State	Brazil
Brazil: Acrelandia	Brazil
Brazil: western Amazon, Rondonia	Brazil
Indonesia: Irian Jaya	Indonesia
Philippines: Agusan del Sur	Philippines
Philippines: Morong	Philippines
Iran: south	Iran
Iran: Ardebil, Pars-Abad	Iran
India: Tripura	India
Malaysia: Sarawak	Malaysia
Indonesia: Kangean island	Indonesia
Indonesia: Trenggalek, Java island	Indonesia
Iran: Chahbahar district, Sistan and Bluchistan province	Iran
India: Jagdalpur, Madhya Pradesh	India
Netherlands: Amsterdam airport	Netherlands
China:Yunnan	China
Iran: Sistan Baluchistan	Iran
Iran: Chabahar	Iran
Gabon: Dienga	Gabon
Papua New Guinea:East Sepik Province, Wosera	Papua New Guinea
China: Yunnan, Tengchong County	China
Iran: Hormozgan Province, Southeast Iran	Iran
Venezuela:Padamo River	Venezuela
Benin:Cotonou	Benin
India:Rourkela,Orissa	India
Turkey:Adana, Cukurova Plain	Turkey
India:Manipur	India
India: Andaman & Nicobar	India
Thailand: Mae Sod	Thailand
Thailand: Mae Hong Sorn	Thailand
Thailand: Prachuap Kriri Khan	Thailand
Thailand: Chanthaburi	Thailand
India: Aligarh, Uttar Prashesh	Thailand
India: Nicobar	India
India: Ranchi, Jharkhand	India
India: Allahabad, Uttar Prashesh	India
Malaysia: Tenom, Sabah, Malaysian Borneo	Malaysia
Malaysia: Nabawan, Sabah, Malaysian Borneo	Malaysia
Malaysia: Malaysian Borneo	Malaysia
Malaysia: Keningau, Sabah, Malaysian Borneo	Malaysia
Malaysia: Tambunan, Sabah, Malaysian Borneo	Malaysia
Iran: Sarbaz district, Southeast Iran	Iran
Iran: south east region	Iran
Iran: Jask district, Southeast Iran	Iran
Iran: south east	Iran
Iran: South East region	Iran
Colombia: Llano bajo	Colombia
Colombia: Sabaletas, Buenaventura	Colombia
Turkey: Sanliurfa	Turkey
Senegal: Pikine	Senegal
Kenya: Kilifi	Kenya
USA: Washington	United States
Jamaica: Kingston	Jamaica
Japan:Kanagawa, Yokohama	Japan
Brazil: Sao Paulo	Brazil
USA: Iowa	United States
Japan: Saitama, the Tone River	Japan
China: Jilin	China
Japan: Hokkaido, Sapporo	Japan
China: Jiading, Xuhang, Caowang	China
USA: Missouri, St. Louis	United States
USA: central California coast, Morro Bay	United States
China:Jiangsu	China
China: Hefei,Anhui Province	China
USA:Utah	United States
USA: California	United States
USA: Massachusetts	United States
China: Ningxia	China
USA: Great Seneca Creek, Maryland	United States
Uganda: Kibale National Park	Uganda
USA: Ohio	United States
Nepal:Kathmandu	Nepal
Chile: Laguna Verde	Chile
China: Hefei	China
Canada: Bras d'Henri and Fourchette River watersheds, Quebec	Canada
USA: Maryland	United States
Canada: Sumas River watershed, British Columbia	Canada
India: Cuddalore, Tamil Nadu	India
USA: Monocacy River, Maryland	United States
Australia: WA	Australia
China: Qingpu, Zhonggu	China
Japan: Aichi, Inuyama	Japan
China: Anhui Province cattle farms	China
China: Jinshan, Ganxiang	China
China: Changchun, Jinlin Province	China
USA:West Virginia	United States
China:Guangdong	China
USA: New York	United States
Saudi Arabia:Jeddah	Saudi Arabia
Kenya: Nairobi	Kenya
India: north India	India
Japan:Miyagi, Osaki, Naruko-onsen, Yomogida, Field Science Center (Kawatabi)	Japan
China: Zhengzhou, Henan Province	China
India: Vellore, Tamil Nadu	India
USA: San Lorenzo River, California	United States
India: A.P., Srinivasa Mangapuram	India
China: Pudong, Laogang	China
USA: Maine	United States
USA: California coast, Moss Landing and Morro Bay	United States
USA: central California coast, near Moss Landing and Morro Bay	United States
Japan:Hokkaido, Nopporo Prefectural Forest Park	Japan
Egypt:Kafr El Sheikh, Sakha	Egypt
Australia: Victoria	Australia
Australia: Southern region	Australia
China: Daqing	China
USA: Floridia	United States
India: Puducherry	India
China: Jiading, Xuhang Sec	China
China: Jiading, Xuhang Thr	China
USA: Virginia	United States
China: Changchun, Jilin Province	China
Japan:Osaka	Japan
Canada: Oldman River watershed, Alberta	Canada
Mexico: Ciudad Juarez	Mexico
Australia: Western Australia	Australia
India: Bangalore	India
Iran: Shahrekord City, Cheharmehal Bakhteyari province, central Iran	Iran
USA: Potomac WFP intake, Maryland	United States
United Kingdom: northwest England, Liverpool	United Kingdom
USA: Waianae, Hawaii	United States
USA: Louisiana	United States
China: Baoshan, Luodian	China
USA: Michigan	United States
USA: Idaho	United States
Iran: Qazvine province	Iran
USA:Pennsylvania	United States
USA:Connecticut	United States
Iran: Tehran and Qazvin provinces	Iran
USA:New York	United States
Switzerland: small lake	Switzerland
USA: Colorado	United States
USA: North Fork Shenandoah River, Virginia	United States
India: Vellore	India
Australia: Western region	Australia
Brazil: Rural University of Rio de Janeiro	Brazil
Kenya: Thika	Kenya
USA: Tulare, CA	United States
USA: central California coast, Carmel and Morro Bay	United States
China: Songjiang, Wulitang	China
China:Anhui	China
China: Beijing	China
Switzerland: lake	Switzerland
United Kingdom: England	United Kingdom
Canada: South Nation River basin, Ontario	Canada
USA: New Orleans	United States
USA: Missouri	United States
Chile: Curauma	Chile
USA: Corbalis WTP intake, Virginia	United States
China: Pudong, Pengzhen	China
China: Chongming, Qianjin farm	China
China: Henan Province	China
USA:Indiana	United States
Spain: Zaragoza	Spain
USA: Minnesota	United States
USA:Maryland	United States
USA:Illinois	United States
Australia: south	Australia
Canada: Ontario	Canada
China: Shanghai	China
India: Kolkata	India
Kenya: Machakos	Kenya
USA: Salinas River, California	United States
China: Shanghai City cattle farms	China
USA: Georgia	United States
Turkey: Aydin	Turkey
Iran: Amol City, Mazandaran Province	Iran
China: Minhang, Pujiang	China
USA: Texas	United States
Switzerland: river	Switzerland
China: Henan province	China
United Kingdom:Orkney	United Kingdom
USA: North Carolina	United States
China: Zhenjiang	China
Japan: Saitama	Japan
China: Cuangzhou	China
United Kingdom:Dartmoor	United Kingdom
USA: Puget Sound, Washington	United States
Canada: Calgary	Canada
USA: Illinois	United States
Australia: Queensland	Australia
India: Kamrup district, Assam	India
Australia: Queensland 1	Australia
Canada: Insect Production Unit (IPU), Great Lakes Forestry Centre, Sault Ste. Marie	Canada
Italy: Monteo Roero, Cuneo	Italy
Russia: West Siberia	Russia
USA: Wisconsin	United States
China: Chongqing	China
Australia: Tasmania 3	Australia
USA: South Dakota	United States
USA: California, Arcata	United States
Japan: Gunma	Japan
Japan: Ehime	Japan
India: Kerala	India
Russia: St. Petersburg	Russia
China: Anhui province	China
Australia: New South Wales 2	Australia
Australia: Tasmania 2	Australia
Canada: New Brunswick	Canada
Iran: Mazandaran	Iran
Australia: New South Wales	Australia
Australia: New South Wales 1	Australia
Japan: Kumamoto	Japan
Slovakia: Krupina	Slovakia
Ireland:Lough Corrib	Ireland
Canada: Prince Edward Island	Canada
Australia: South Australia	Australia
Australia: Tasmania	Australia
China: Zhenjiang Jiangsu	China
USA: Utah	United States
Italy: San Raffaele Cimena, Torino	Italy
Argentina: Buenos Aires, La Plata	Argentina
Canada: Nova Scotia	Canada
Argentina: Buenos Aires	Argentina
Australia: Queensland 2	Australia
USA: Arkansas, Fayetteville	United States
United Kingdom:Yorkshire	United Kingdom
United Kingdom:Oxford	United Kingdom
United Kingdom:Weymouth, Newtons Cove	United Kingdom
USA: Alaska, Fairbanks	United States
Australia: Queensland 3	Australia
Australia: Tasmania 1	Australia
Iran: Shahrekord	Iran
Canada: North Bay	Canada
Ireland:Lough Erne	Ireland
Italy: Valfenera, Asti	Italy
Italy: Grugliasco, Torino	Italy
France: Franconville	France
Germany: Hannover	Germany
Japan:Shimane, Hatahiyodori	Japan
Japan:Tokyo, Mikura Island	Japan
France: Gard	France
Germany:Hannover	Germany
Japan: Shimane, Daito	Japan
Russia: Khabarovsk Territory	Russia
Russia: Vladivostok	Russia
Poland: Mazury Lake District	Poland
USA: Montana, Big Sky	United States
Russia: Novosibirsk region	Russia
Belgium: Mont	Belgium
Belgium: Bruyelles	Belgium
Turkey: Gumushane	Turkey
Belgium: Theux	Belgium
Germany: Munich, Nymphenburger Schlosspark	Germany
Netherlands: Arnhem	Netherlands
Belgium: Celles	Belgium
Argentina: Provincia de Buenos Aires	Argentina
Argentina: Salta Province	Argentina
Belgium: Finnevaux	Belgium
Switzerland: Aargau	Switzerland
Belgium: Erezee	Belgium
Switzerland: Fribourg	Switzerland
USA: Maine:VH	United States
Spain: Basque Country	Spain
Italy: RG	Italy
China: Xiaogan, Hubei province	China
Mongolia:Khentii Undurkhan	Mongolia
Japan: Hokkaido, Shintoku	Japan
Iran: Qazvin Province, Takistan	Iran
China: Gansu province, Lintao county	China
Spain: Burgos	Spain
Thailand: Surin, SUC	Thailand
Japan: Hokkaido, Taiki	Japan
Iraq: Kurdistan Region	Iraq
South Africa:Natal	South Africa
India: Taluka Akole Dist., Ahmednagar State, Maharashtra	India
USA: Placer County, California	United States
Japan:Akita, Takanosu	Japan
Japan:Hokkaido, Akkeshi	Japan
Japan:Nemuro	Japan
Netherlands: Texel	Netherlands
Taiwan: Nantou	Taiwan
USA: Webb County, Texas	United States
South Africa:Onderstepoort Veterinary Academic Hospital	South Africa
USA: LaSalle County, Texas	United States
Belgium: La Reid	Belgium
USA: Massachusetts, Nantucket	United States
Mexico: Tabasco State	Mexico
Argentina: Corrientes Province	Argentina
Brazil: North region	Brazil
Belgium: Houffalize	Belgium
USA: Massachusetts, Cape Cod	United States
Argentina: Mercedes, Corrientes Province	Argentina
USA: Connecticut, Old Lyme	United States
Switzerland: Tessin, Freggio	Switzerland
Belgium: Ravels	Belgium
India:Uttar pradesh	India
Turkey: Cankiri	Turkey
Russia: North Ural, State Nature Reserve 'Denezhkin Kamen', Sverdlovsk region	Russia
USA: Cordova, Alaska	United States
Italy: BN	Italy
South Africa: Willem Pretorius game reserve	South Africa
Iran: Fars, Rahmat-Abad	Iran
India: Hissar	India
Tunisia: Northern Site 1	Tunisia
Turkey: Erzincan	Turkey
Iraq: Kudistan region, Duhok	Iraq
Mongolia:Uvs Ulaangom	Mongolia
Japan: Hokkaido, Shin-Hidaka	Japan
Brazil: DF, Brasilia	Brazil
Iran: Fars, Dariuon	Iran
Iran: Qazvin Province, Abeyek	Iran
China: Gansu province, Weiyuan county	China
Japan:Kumamoto, Kuma	Japan
China: Zhangjiachuan	China
Iran: Ilam	Iran
China: Lintan region	China
China: Suizhou County, Hubei Province	China
Japan: Chitose, Hokkaido	Japan
Italy: Marche-Macerata	Italy
Japan: Hokkaido	Japan
Japan:Kobe, Awaji Island	Japan
Japan:Tokushima, Anan, Tsukiyo	Japan
Netherlands: Ameland	Netherlands
Japan: Hokkaido, Akkeshi	Japan
Japan: Okinawa	Japan
USA: TX	United States
Japan:Okinawa	Japan
Germany: Ingolstadt, Luitpoldpark	Germany
Switzerland: Bern	Switzerland
Switzerland: Tessin, Gudo	Switzerland
Italy: Bagno di Romagna, Forli-Cesena	Italy
Mexico: Mexico City	Mexico
Switzerland: Zurich	Switzerland
Belgium: Beveren	Belgium
France: Reunion Island	France
Italy: Fontanelice, Bologna	Italy
Belgium: Zichem	Belgium
Russia: Novosibisk region	Russia
Turkey: Kayseri	Turkey
Japan:Hokkaido, Esashi	Japan
Japan: Aomori	Japan
USA: Montague, Alaska	United States
Iran: Fars, Torbeh	Iran
Tunisia: Northern Site 6	Tunisia
Japan: Shiga, Yamanaka	Japan
Mongolia:Khentii Tsenkher-mandal	Mongolia
Viet Nam:Hue	Vietnam
China: Guizhou, Guiyang County	China
South Africa: Natal	South Africa
Iran: Fars	Iran
Brazil: SP, Jundiai	Brazil
Thailand: Roi Ed, RD	Thailand
Thailand: Chiang Mai, CM	Thailand
Iran: Khouzestan	Iran
Iran: Qazvin, Boein-Zahra	Iran
Thailand:southern, Thung Song	Thailand
South Africa:Kruger National Park	South Africa
Japan:Tochigi, Kanuma	Japan
Italy: Emilia Romagna-Ferrara	Italy
Tunisia:Tunis	Tunisia
Italy: Emilia Romagna-Forli	Italy
China: Ningxian	China
Taiwan: Taichung	Taiwan
Japan: Nemuro	Japan
Netherlands: The Hague	Netherlands
Germany: Berg, Schlosspark	Germany
Mexico: Merida	Mexico
Belgium: Chevetogne	Belgium
Spain: Galicia	Spain
Germany: Regensburg, Doernbergpark	Germany
Brazil: Pelotas	Brazil
Brazil: Recife	Brazil
Belgium: Arbrefontaine	Belgium
Puerto Rico	United States
Virgin Islands	Unknown
Taiwan: Tainan	Taiwan
USA: Massachusetts:Ipswich	United States
USA: Alaska:Cordova	United States
Japan: Chiba, Ohtaki, Hirasawa	Japan
Italy: Veneto-Vicenza	Italy
USA: Maine:GLS	United States
China:Fujian	China
Mongolia:Khentii Jargaltkhan	Mongolia
Iran: Qazvin Province, Qazvin	Iran
Japan: Yamaguchi Prefecture	Japan
Thailand: Srisaket, SS	Thailand
India: Chennai, Tamil Nadu	India
Iran: Fars, Korbal	Iran
Japan: Iwate	Japan
Italy: Friuli V.G.-Udine	Italy
Japan: Hokkaido, Hokkaido University	Japan
France: Marne, Trois Fontaines	France
USA: Texas, Smith County	United States
USA: Massachusetts, Naushon	United States
Russia:Perm Territory	Russia
Belgium: Aublain	Belgium
Russia: South-Western Siberia	Russia
USA: Massachusetts, MV	United States
Syria: central region	Syria
Russia: Mis	Russia
USA: Alaska, Cordova	United States
USA: Massachusetts, Ipswich	United States
Hungary: Papa	Hungary
USA: Zapata Co., TX	United States
Iran: Bookat	Iran
Turkey: Ankara	Turkey
Tunisia: Northern Site 3	Tunisia
Tunisia: Northern Site 15	Tunisia
Sudan: Soba	Sudan
Tanzania: Lekoko Okarina	Tanzania
Mongolia:Uvurkhangai Bogd	Mongolia
Mongolia:Khentii Dadal	Mongolia
Iran: Karaj	Iran
Iran: Urmia	Iran
Thailand: Lumpang, LP	Thailand
Zimbabwe: Hunyani Estate, Norton	Zimbabwe
China: Guangxi province, Guilin county	China
Turkey:Ankara	Turkey
Japan:Okinawa, Yonaguni	Japan
China: Gansu province, Dingxi county	China
Iran: Zabol	Iran
Kenya: North Eastern province, Garissa	Kenya
Italy: Umbria-Perugia	Italy
USA: Texas, Tom Green County, north	United States
Mexico: Veracruz State	Mexico
Belgium: Briquemont	Belgium
Brazil: South region	Brazil
USA: Texas, Tom Green County, south	United States
Switzerland: Ruetiwis	Switzerland
USA: Kentucky	United States
Belgium: Sart Lez Spa	Belgium
USA:California, Kern County	United States
Belgium: Stoumont	Belgium
USA:Georgia	United States
Germany: Munich, Englischer Garten	Germany
United Kingdom:Cornwall	United Kingdom
France: Deux Sevres, Wild Fauna Reserve of Chize	France
USA: Maine, GLS	United States
Switzerland: Tessin, Agno	Switzerland
South Africa: Kruger National Park	South Africa
Iran: Tehran, Vasfenard	Iran
Italy: Northern Sicily Site A14	Italy
Thailand: Surin, SUA	Thailand
Iran: Golestan	Iran
Thailand: Chiang Rai, CR	Thailand
Thailand: Burirum, BR	Thailand
Brazil: SP, Ribeirao Preto	Brazil
India:Hisar	India
Japan:Iwate, Kuriyagawa	Japan
Italy: Emilia Romagna-Bologna	Italy
France: Machecoul	France
United Kingdom:Bristol	United Kingdom
Brazil: Northeast region	Brazil
Belgium: Spixhe	Belgium
Switzerland: Tessin, Isone	Switzerland
Switzerland: Neuchatel	Switzerland
USA:Georgia, Atlanta	United States
Hungary: Budapest	Hungary
Belgium: Stembert	Belgium
USA: Maine, VH	United States
Belgium: Mariembourg	Belgium
Japan:Tokyo	Japan
Belgium: Vemont	Belgium
Germany: Ingolstadt, Glacis	Germany
China: HKSAR	China
Belgium: Foy Notre D	Belgium
USA: Wisconsin, Spooner	United States
Switzerland: Tessin, Claro	Switzerland
Brazil: State of Rio Grande do Sul	Brazil
Russia: South-Western Siberia, Novosibirsk region	Russia
Tunisia: Northern Site 16	Tunisia
Sudan: Atbara	Sudan
Turkey: Elazig	Turkey
Mongolia:Khentii Binder	Mongolia
South Africa: Hartebeestpoort, Pretoria	South Africa
Tanzania: Ngorongoro Crater	Tanzania
Japan:Kumamoto, Aso	Japan
China: Qinghai	China
Thailand: Roi Ed, RE	Thailand
China: Gansu province, Lintan county	China
China: Jinlin province, Changchun county	China
China: Suizhou County	China
Spain: Catalonia	Spain
Kenya: Nairobi, Giraffe centre	Kenya
Taiwan: Kaohsiung, Meishan	Taiwan
China: Lintan	China
Japan: Kobe, Hyogo, Kamihara Animal Hospital	Japan
Taiwan: Taipei	Taiwan
Japan:Hokkaido, Ashoro	Japan
Belgium: Vierves	Belgium
Turkey:Istanbul	Turkey
South Africa: Port Elizabeth	South Africa
Brazil: Midwest region	Brazil
Belgium: Herentals	Belgium
Brazil: Southeast region	Brazil
Germany: Munich, English Garden	Germany
Germany: Regensburg, Donaupark	Germany
Belgium: Louveigne	Belgium
Belgium: Spontin	Belgium
Belgium: Warempage	Belgium
Italy: Modena	Italy
Germany: Munich, Langwieder See	Germany
Japan:Iwate	Japan
USA: Arizona	United States
Turkey: Karabuk	Turkey
Mexico: near Mexico City	Mexico
China: Xinjiang	China
USA: Massachusetts:Nantucket	United States
Iran: Kazeroon	Iran
Iran: Varamin	Iran
Tunisia: Northern Site 4	Tunisia
Turkey: Malatya	Turkey
Spain: Caceres	Spain
Spain: Cadiz	Spain
Turkey: Giresun	Turkey
Iran: Qazvin Province, Boeen Zahra	Iran
Turkey: Amasya	Turkey
China: Xinjiang, Yining	China
China: Madang	China
Kenya:Nanyuki	Kenya
India: Taluka Sangamner Dist., Ahmednagar State, Maharashtra	India
China: Jiangsu	China
Philippines:Palawan	Philippines
Thailand: Mae Sot	Thailand
Nicaragua: Realejo	Nicaragua
Mexico: San Fco. Campamento	Mexico
China: Henan	China
Iran:Sistan and Bluchestan, Chabahar	Iran
Mexico: Cton. San Carlos	Mexico
Iran:Hormozgan, Minab	Iran
China: Tibeten autonomous region	China
Mexico: Rancheria Sta. Rita	Mexico
Nicaragua: Chinandega town	Nicaragua
Brazil: Amazonas	Brazil
Mexico: Chespal Nuevo	Mexico
Mexico: Canton San Nicolas lagartero	Mexico
Peru: Sullana	Peru
Iran:Hormozgan, Jask	Iran
Mexico: Mapastepec town	Mexico
Mexico: Tapachula city	Mexico
Mexico: El Caucho	Mexico
Nicaragua: Chichigalpa	Nicaragua
Mexico: Puerto Madero	Mexico
Mexico: San Rafael Toltepec	Mexico
Mexico: El Retiro II	Mexico
Hungary: Erd Creek	Hungary
Iceland: bay of Breidafjordur	Iceland
Japan:Hokkaido, Kushiro, Akan	Japan
United Kingdom: Houghton	United Kingdom
China: Hubei	China
USA: MD	United States
Japan: Hyogo, Shisou-City, Fukuchi	Japan
USA:Washington, Gertrude Island	United States
Canada-BC	Canada
USA-MD	United States
Burkina Fasco	Burkina Faso
Brazil: Rio Grande do Sul	Brazil
Yugoslavia	europe
Hungary: Pond farm	Hungary
Australia:Victoria	Australia
India: Andra Pradesh	India
China: Guangzhou	China
Iran:Tehran, Tehran	Iran
USA: TX, Brownsville, Gladys Porter Zoo	United States
USA: Mississippi	United States
Puerto Rico:Mona Island	United States
United States:New Jersey	United States
Holland	Netherlands
Hungary: Lesence Creek	Hungary
Hungary: Tapolca Creek	Hungary
Australia:Queensland	Australia
Portugal: Beja	Portugal
Japan: Oita	Japan
USA: Washington State	United States
Australia:Taronga Western Plains Zoo, New South Wales	Australia
Australia: Northern Territory, Tanami desert	Australia
China: Nanjing	China
Iran: Khuzestan province	Iran
Italy:Lombardia	Italy
USA-IA	United States
United States:Iowa and Minnesota	United States
United States:Iowa	United States
Hungary: Lake Balaton	Hungary
Japan: Aichi	Japan
Brazil: Campinas	Brazil
Iran:Teharn, Tehran	Iran
USA: Manhattan, KS	United States
USA:Oregon, South Beach	United States
France (Brest)	France
United States:South Carolina coast	United States
Brazil:Rio Grande do	Brazil
United States:Massachusetts	United States
United States	United States
United Kingdom: Brittain, North Atlantic	United Kingdom
Hungary: Danube River	Hungary
China: Panyu	China
Australia: Taronga Western Plains Zoo, New South Wales	Australia
Iran: Kordestan	Iran
Brazil: Minas Gerasi, Lavras	Brazil
USA: MS	United States
China:Shanghai province	China
USA-CA	United States
United States:Illinois	United States
Brazil:Alagoas	Brazil
Brazil:Sergipe	Brazil
Brazil:Maranhao	Brazil
Colombia:Bogota	Colombia
Brazil:Pernambuco	Brazil
Brazil:Parana	Brazil
Japan:Kagoshima, Izumi	Japan
Tanzania: Gombe National Park	Tanzania
Japan: Kanazawa	Japan
Japan:Hokkaido	Japan
Australia: University of Sydney	Australia
China:Qinghai province	China
China:Hunan province	China
France (Nice)	France
United States:Maryland, Virginia and West Virginia	United States
Colombia:Armenia	Colombia
Brazil:Sao Paulo city	Brazil
Brazil:Sao Paulo	Brazil
Africa	africa
Reunion Island	France
Hungary: Lake Kis-Balaton	Hungary
China: Henan Province, Kaifeng	China
Japan:Hokkaido, Akan, Tsurui	Japan
Kenya: Mt. Kenya	Kenya
Argentina: La Plata	Argentina
USA: VA	United States
China:Guangdong province	China
USA:Washington, Washaway Beach	United States
USA:Oregon, Florence	United States
United States:California & Washington	United States
United States:Maryland	United States
St. Kitts	Saint Kitts and Nevis
United States:Wisconsin	United States
Brazil:Sao Paulo state	Brazil
United States:Pennsylvania 	United States
UK	United Kingdom
Japan:Hokkaido, Shibecha	Japan
China: Jiangsu, Nanjing	China
China: Huzhu	China
Spain: Balearics Islands, Cabrera	Spain
China:Guangzhou	China
USA-NH	United States
France (Strasbourg)	France
Brazil:Rio de Janeiro	Brazil
Brazil:Bahia	Brazil
Brazil:Ceara	Brazil
Brazil:Para	Brazil
India:Lucknow	India
Brazil: Sao Paulo, SP	Brazil
Brazil: Joinville, SC	Brazil
Brazil: Monte Negro, RO	Brazil
Brazil: Jurumirim, SP	Brazil
Brazil: Campo Grande, MS	Brazil
Iran: immunodeficiency wards of hospital	Iran
Iran: Azarbaijan	Iran
Iran:Tehran	Iran
Iran: Tehran	Iran
Iran: Bandar Abbas Port	Iran
Thailand:Bangkok	Thailand
Philippines: Kalibo, Aklan	Philippines
Philippines: Union Kalinga, Isabela	Philippines
Philippines: Tagdana, Ilocos Sur	Philippines
Philippines: Dagupan, Pangasinan	Philippines
Philippines: Nagdanaoan, Burgos, Ilocos Sur	Philippines
Philippines: University of the Phillippines, Cebu Campus	Philippines
Philippines: Sto. Domingo, Mercedes, Isabela	Philippines
Philippines: Capul Island, Northern Samar	Philippines
Philippines: Manila	Philippines
Philippines: Usul Jones, Isabela	Philippines
Philippines: Antipolo	Philippines
Philippines: Cainta, Rizal	Philippines
Philippines: Lumaba, Villaviciosa, Abra	Philippines
Italy: Vercelli	Italy
Italy: Apulia Region, Policlinico Hospital, University of Bari	Italy
Spain: Canary Islands, Tenerife	Spain
Spain: Madrid	Spain
Spain: Andujar	Spain
Germany: Koblenz, Ernst-Rodenwaldt Institute	Germany
France: Seine River, 30 km south of Paris, upstream from a drinking water production plant	France
France:Lascaux Cave	France
Japan:Aichi, Toyoake city	Japan
Japan:Nagasaki	Japan
Japan: Tokyo	Japan
Japan:Aichi, Toyoake	Japan
China:GuangXi Province	China
China: GuangXi	China
China: Qingdao	China
China:GuiZhou Province	China
Nepal: Kathmandu	Nepal
West Bank: Nablus	asia
West Bank: Palestine, Nablus	asia
Indonesia: Siberut	Indonesia
USA: Cape Cod, Massachusetts	United States
Japan:Yamanashi, Kofu	Japan
Japan:Aichi	Japan
USA: Chatham, MA	United States
USA: San Francisco County, CA	United States
Norway: Fiskfjord	Norway
China:Anhui province	China
Indonesia: Sumba, Waitabula	Indonesia
South Korea:seoul	South Korea
Australia: Wyndham	Australia
Canada: New Brunswick, Kent Island	Canada
USA: Muskeget, MA	United States
Italy: Oreto River, Sicily	Italy
USA: Alaska	United States
Indonesia: Sumba, Baliloku	Indonesia
Spain: Barcelona	Spain
Italy: central	Italy
USA: Monomoy, MA	United States
USA: Appledore Island, ME	United States
Norway: Sordal	Norway
Japan: Aomori, Shimokita peninsula	Japan
Iran: Razavi Khorasan Province, Mashhad	Iran
Iran: Razavi Khorasan Province, Torbat-e Heydarieh	Iran
USA: Cape Cod, MA	United States
Uganda: Kampala	Uganda
USA: Dennis, MA	United States
Norway: Glomma	Norway
United Kingdom:London	United Kingdom
Iran: Golestan Province, Gonbad-e Qabus	Iran
Australia: Rockingham	Australia
Japan:Kanagawa	Japan
USA: Wellfleet, MA	United States
Spain:Comunidad Valenciana	Spain
Tunisia: Grombalia	Tunisia
Norway: Tana	Norway
Indonesia: Sumba	Indonesia
Norway: Alta	Norway
Norway: Lakselv	Norway
China:Anhui Province	China
Indonesia: Makassar	Indonesia
Japan:Aichi, Inuyama	Japan
Iran: West Azerbaijan Province, Maku	Iran
USA: Nantucket Island, MA	United States
Japan:Yamanashi, Fujikawa	Japan
USA: Martha's Vineyard Island, MA	United States
Australia: Woodanilling	Australia
Uganda: western Uganda, Kibale National Park	Uganda
USA: Nantucket Island, Massachusetts	United States
Canada: Kent Island, New Brunswick	Canada
Western Sahara	africa
USA: West Virginia	United States
Tunisia: Chotranda	Tunisia
Japan:Yamanashi, Fujikawa, Fujikawa River	Japan
South Korea:Seoul	South Korea
Norway: Koifjorden	Norway
Russia:Lake Baikal	Russia
USA: Martha's Vineyard, Massachusetts	United States
Australia: Perth	Australia
USA: Oregon	United States
USA: Marin County, CA	United States
USA: Chatham, USA	United States
Mexico: San Luis Potosi	Mexico
Egypt: Red Sea	Egypt
Czech Republic: New Town of Prague	Czech Republic
Russia: Lake Baikal	Russia
China: Liwan, Guangzhou, Guangdong	China
India: Bhandara, Maharashtra	India
Ireland:Country Waterford	Ireland
Venezuela: Miranda	Venezuela
Guatemala: Jutiapa	Guatemala
Chile: Flor de Valle	Chile
Peru: Majes	Peru
Cote d'Ivoire: Kouassi-Perita	Ivory Coast
Egypt: Alexandria	Egypt
Russia: Cape Kartesh, Tshupa Bay, White Sea, North Russia	Russia
Brazil:Espiruto Santo	Brazil
China: Gansu Province	China
Brazil: Mossoro, RN	Brazil
Brazil: Dourados, MS	Brazil
Brazil: Castanhal, PA	Brazil
Brazil: Londrina, PR	Brazil
Croatia: Pula	Croatia
Venezuela: El Baul, San Carlos	Venezuela
Brazil: Patos, PB	Brazil
Brazil: RS	Brazil
United Kingdom:St Kilda	United Kingdom
Tanzania: Maswa Game Reserve	Tanzania
Mozambique:Centre - Sofala	Mozambique
Brazil: Mato Grosso do Sul	Brazil
Brazil: Ceara	Brazil
Colombia: Galeras, Sucre	Colombia
Brazil: Amazon, Apui	Brazil
Brazil: Macapa, AP	Brazil
Colombia: Caqueta	Colombia
Brazil: Aquidauana, MS	Brazil
Brazil: Amazon, Manaus	Brazil
Brazil: Morada Nova, RN	Brazil
Brazil: Amazon, Barcelos	Brazil
Brazil: Bolivia	Brazil
Brazil: MIranda, MS	Brazil
Colombia: Arauca	Colombia
Brazil: Sao Luiz, MA	Brazil
China: Zhejiang	China
Democratic Republic of the Congo:Bandundu	Democratic Republic of the Congo
Russia:North-West	Russia
Brazil: Rolandia, SP	Brazil
Brazil: Alfenas, MG	Brazil
Brazil: Arapongas, PR	Brazil
China: Sichuan	China
China: Gansu province	China
Uzbekistan:Pap district	Uzbekistan
Iran: Torkman Sahra,Golestan province	Iran
Nepal: Bardiya	Nepal
Mexico: Yucatan	Mexico
Israel:Occupied Palestinian Territories	Israel
Turkey: Hatay region	Turkey
United Kingdom:Bath	United Kingdom
Panama: Panama Canal Zone, Gigante	Panama
Argentina: Chaco	Argentina
Mexico: Campeche	Mexico
Venezuela: Barinas	Venezuela
Venezuela: Sucre	Venezuela
Venezuela: Anzoategui	Venezuela
Guatemala: Baja Verapaz	Guatemala
Russia: White Sea, North Russia, Chupa inlet, cape Kartesh	Russia
China: Peiking	China
India:Uttar Pradesh	India
Zambia: North Luangwa National Park	Zambia
Cote d'Ivoire: Koudougou	Ivory Coast
Peru: Department of La Libertad, Pedregual	Peru
Brazil: Santarem, PA	Brazil
Brazil: Jacupiranga, SP	Brazil
Brazil: Catole da Rocha, PB	Brazil
Brazil: ElDorado, SP	Brazil
Brazil:Centre - Miranda	Brazil
Senegal:Dakar	Senegal
Pakistan:Sono Khan	Pakistan
Brazil: Pantanal region, MS	Brazil
Brazil: Guarulhos, SP	Brazil
Brazil: Bonito, MS	Brazil
Brazil: Amazon, Maraa	Brazil
Colombia: Norte de Santander	Colombia
Colombia: Magdalena	Colombia
Brazil: Araraquara, SP	Brazil
Brazil: Ilha Bela, SP	Brazil
Brazil: Placido de Castro, AC	Brazil
Brazil: Chile	Brazil
Brazil: Minas Gerais	Brazil
Brazil: Bodoquena, MS	Brazil
Ethiopia:Illubabor	Ethiopia
Kenya:Lambwe Valley	Kenya
Brazil: Goiania, GO	Brazil
Brazil: Rolandia, PR	Brazil
Brazil: Cotia, SP	Brazil
Russia: North, White Sea region	Russia
Sudan:Gedarif	Sudan
Ethiopia: Konso	Ethiopia
India: Bihar	India
Iran: Khuzestan, Shush	Iran
Iran: Esfahan	Iran
China: Shandong province	China
Panama: Panama Canal Zone, Guava	Panama
Guatemala: Chiquimula	Guatemala
Bolivia: Tupiza	Bolivia
Brazil: Miranda, MS	Brazil
Sudan: Yambio	Sudan
USA: Pensylvania	United States
United Kingdom:Pitroddie, Scotland	United Kingdom
Nigeria: Zaria	Nigeria
Tanzania:Sangaiwe	Tanzania
Brazil: Corumba, MS	Brazil
Brazil: Mogi Mirim, SP	Brazil
Brazil: Belem, PA	Brazil
Brazil: Porto Velho, RO	Brazil
Brazil: Monte Negro, Rondonia	Brazil
Brazil: Monte Alegre do Piaui	Brazil
Brazil: Marilia, Sao Paulo	Brazil
Brazil: Barcelos, Amazonas	Brazil
Brazil: Sao Joao da Boa Vista, SP	Brazil
Brazil: Rio Branco, AC	Brazil
Venezuela: Caracas	Venezuela
India:Rajasthan:Bikaner	India
Cote d'Ivoire:Daloa	Ivory Coast
Czech Republic: South Moravia	Czech Republic
Brazil: Itapetininga, SP	Brazil
USA: Lincoln, NE	United States
Guatemala: Chichicastenango	Guatemala
USA: Minnetonka, MN	United States
Sudan:Eastern Sudan	Sudan
Ethiopia:Northwest Ethiopia	Ethiopia
Ethiopia: Omo-Valley	Ethiopia
Iran: Khuzestan, Susangerd	Iran
India:Bihar	India
Iran: Dehloran	Iran
Iran: Ghasre Shirin, Nasr Abad District, Kermanshah Province	Iran
Thailand: Phang-nga	Thailand
Brazil: Carajas	Brazil
Guatemala: Alta Verapaz	Guatemala
Guatemala: Jalapa	Guatemala
Venezuela: Dto Capital	Venezuela
Colombia: Bajo Calima	Colombia
Chile: Cuncumen	Chile
Zambia: Luangwa Valley	Zambia
Cote d'Ivoire: Daloa	Ivory Coast
Russia: Kaliningrad region, West Russia	Russia
Russia: Leningrad region, North-West Russia	Russia
China: Sichuan Province	China
Peru: Department of La Libertad, Nambuque	Peru
Czech Republic:Prague	Czech Republic
Venezuela: San Fernando, Apure	Venezuela
Brazil: Pantanal, MS	Brazil
Tanzania:Msubugwe	Tanzania
Brazil: Piedade, SP	Brazil
Brazil: Taguatinga	Brazil
Brazil: Tocantins	Brazil
Chile: fourth region	Chile
Brazil: Rio Negro, AM	Brazil
Colombia: Boyaca	Colombia
Brazil:Rondonia	Brazil
Brazil: Marajo Island, PA	Brazil
Brazil: Sao Paulo,SP	Brazil
Brazil: Araraquara,SP	Brazil
Thailand: Lad Kra Bang, Bangkok	Thailand
Thailand: Lad Krabang, Bangkok	Thailand
Zambia:Luangwa Valley	Zambia
USA: Ocochobee, FL	United States
USA: Minneapolis, MN	United States
Russia: North-West	Russia
China: Inner Mongolia	China
Sudan:Sennar	Sudan
Sudan: Eastern Sudan, Gedaref	Sudan
Nepal: Sarlahi	Nepal
Iran: Khuzestan, Hoveyzeh	Iran
Iran: Khuzestan, Hendijan	Iran
China: Jiangsu province	China
Brazil: Alto do Rio Negro, AM	Brazil
Argentina: rural area of Santiago del Estero	Argentina
Panama: Panama Canal Zone, Bohio	Panama
Panama: Panama Canal Zone, Guanabano	Panama
Mexico: Morelos	Mexico
Venezuela: Lara	Venezuela
Mexico: Queretaro	Mexico
Mexico: Baja California Sur	Mexico
Mexico: Oaxaca	Mexico
USA: Florida	United States
Brazil: Bahia	Brazil
Peru: Vitor	Peru
Paraguay: San Pedro	Paraguay
Bolivia: Santa Cruz	Bolivia
Brazil: Confresa, MT	Brazil
Guinea-Bissau: Buba, Cufada	Guinea-Bissau
China: Shandong Province	China
Tanzania: Serengeti National Park	Tanzania
Venezuela: San Felipe, Yaracuy	Venezuela
Brazil: Indaiatuba, SP	Brazil
Brazil:Northeast - Catole	Brazil
Zambia: Lumimba Game Management Area	Zambia
Brazil: Florianopolis, Santa Catarina	Brazil
Brazil: Posse	Brazil
Brazil: Ituiutaba	Brazil
Brazil: Amazon, Coari	Brazil
Colombia: Antioquia	Colombia
Brazil: Barcelos, AM	Brazil
Brazil: Braganca, PA	Brazil
Colombia: Cesar	Colombia
Brazil: Ribeirao Cascalheira	Brazil
Colombia: Casanare	Colombia
Uganda:Busoga	Uganda
Zambia: Munyamadzi Game Management Area	Zambia
India:Himachal Pradesh	India
Nepal: Bara	Nepal
Iran:Kashan	Iran
Iran: Khuzestan, Ahvaz	Iran
Iran: Kermanshah	Iran
Iran:Esfahan	Iran
Iran: Ghasre Shirin, Kermanshah Province	Iran
Iran: Damghan	Iran
Cyprus:Limassol	Cyprus
Iran:Sarakhs	Iran
Guatemala: Santa Rosa	Guatemala
Bolivia: Beni	Bolivia
Venezuela: Portuguesa	Venezuela
Honduras: Tegucigalpa	Honduras
Brazil: Belem	Brazil
Chile: Tulahuen	Chile
Nigeria: Nsukka	Nigeria
Chile:Tulahuen	Chile
China: Jiangsu Province	China
Brazil: Piaui State	Brazil
Venezuela: El Baul, Cojedes	Venezuela
Brazil: Eldorado, SP	Brazil
Thailand: Buriram, Thai	Thailand
Venezuela: Merida, Merida	Venezuela
USA: Pennsylvania	United States
Brazil: Porto Alegre, RS	Brazil
Brazil: Aracatuba, SP	Brazil
Mozambique: Tete	Mozambique
Brazil: Pernambuco state	Brazil
Brazil: Biritiba Mirim, SP	Brazil
Brazil: Adrianopolis, Parana	Brazil
Brazil: Sao Desiderio	Brazil
Brazil: Campo Limpo, GO	Brazil
Brazil: Itacoatiara, Amazonas	Brazil
Colombia: San Agustin, Huila	Colombia
Brazil: Amazon, Monte Arabe	Brazil
Brazil: Manaus, AM	Brazil
Brazil: Acre	Brazil
Brazil: Amazon, Careiro da Varzea	Brazil
Thailand: Khai Bang Rachan, Sing Buri	Thailand
Tanzania:Mivumoni	Tanzania
Thailand: Samut Prakan	Thailand
Brazil: Bastos, SP	Brazil
China: Gansu	China
China: Shandong	China
Sudan: Eastern Sudan, Gedaref State	Sudan
USSR	Russia
China: Sichuan province	China
China: Xinjiang Uygar Autonomous Region	China
Mexico: Michoacan	Mexico
Colombia: Guadual	Colombia
Bolivia: Cochabamba	Bolivia
Bolivia: La Paz	Bolivia
Mexico: Veracruz	Mexico
Paraguay: Boqueron	Paraguay
Colombia: Carimaga	Colombia
Bolivia: Alto Beni	Bolivia
Paraguay: Paraguari	Paraguay
Chile: Francia	Chile
Tanzania: Serengeti	Tanzania
China: Xinjiang Uygur Autonomous Region	China
Spain:Badalona	Spain
Brazil: Amazon basin	Brazil
Japan: Aomori, Takko	Japan
Brazil: PR	Brazil
Brazil: Registro, SP	Brazil
Zambia: Musalangu Game Management Area	Zambia
Brazil: Pocone, MT	Brazil
Mozambique: Maputo	Mozambique
Mozambique: Sofala	Mozambique
Brazil: Pantanal	Brazil
Brazil: Catole da Rocha, RN	Brazil
United Kingdom:Wytham	United Kingdom
Brazil: Buritizal	Brazil
Brazil: Sao Bernardo do Campo, SP	Brazil
Mozambique: Marromeu	Mozambique
Brazil: Campo Limpo, Goias	Brazil
Brazil: Juquitiba, SP	Brazil
Brazil: Amazon, Santa Isabel do Rio Negro	Brazil
Brazil: Itacoatiara, PA	Brazil
Brazil: Rio Grande do Norte	Brazil
Brazil: Goias	Brazil
Brazil: Tapirape Aquiriri, PA	Brazil
Brazil: Tocantins, TO	Brazil
Brazil: Ilha Bela,SP	Brazil
India: Maharashtra, Raigad	India
Zambia:Luangwa valley	Zambia
Russia: Elista (Kalmykia)	Russia
Spain:Mallorca	Spain
China: Wenchuan	China
Iran: Kashan	Iran
Iran: Khuzestan, Ramhormoz	Iran
Cyprus:Paphos	Cyprus
China: Peking	China
Thailand: Satun	Thailand
Thailand: Trang	Thailand
Panama: Panama Canal Zone, Leon	Panama
Venezuela: Merida	Venezuela
Bolivia: Cotopachi	Bolivia
Paraguay: Pr. Hayes	Paraguay
Chile: Region IV	Chile
Venezuela: Guarico	Venezuela
Brazil: Rio Gr. do Sul	Brazil
Chile: Limari	Chile
Brazil: Confesa, MT	Brazil
Brazil: Rio de Janeiro	Brazil
Russia: Pskov region, North-West Russia	Russia
Tanzania: Grumeti Game Reserve	Tanzania
Peru:Department of La Libertad, Pedregual	Peru
Peru:Department of La Libertad, Nambuque	Peru
Brazil: Pariqueracu, SP	Brazil
Brazil: Bujaru, PA	Brazil
Brazil: Sao Mamede, PB	Brazil
Brazil: Pariquera	Brazil
Croatia: Goljak	Croatia
Tanzania:Tarangire	Tanzania
Brazil: Belem, Para	Brazil
Brazil: RO	Brazil
Japan:Kagoshima	Japan
Tanzania:Tanga	Tanzania
Brazil: Miranda, Mato Grosso do Sul	Brazil
Mozambique: Chupanga	Mozambique
Brazil: Araguaina	Brazil
Brazil: Palmas	Brazil
Brazil: Amapa	Brazil
Colombia: Tolima	Colombia
Brazil: Bonito, Mato Grosso do Sul	Brazil
Brazil: Eldorado,SP	Brazil
Brazil: Ananindeua, PA	Brazil
Egypt: Cairo	Egypt
Kenya:Muhaka forest, Ukunda	Kenya
Brazil: Pantanal, MT	Brazil
Kenya:Alego	Kenya
Zambia:Kasyasya	Zambia
Russia: Leningrad Oblast	Russia
Iran: Khorasan	Iran
Brazil:Acre	Brazil
Brazil:Amazonas	Brazil
Sudan: Algadarif	Sudan
Antarctica	antarctica
Australia:Kangoroo island	Australia
Australia:Western Australia	Australia
Brazil: Porto Alegre	Brazil
China: Changchun	China
China: Dianchi Lake, Yunnan Province	China
China: YongJi City, ShanXi Province	China
China:Hong Kong	China
Czech Republic: Cerna brook	Czech Republic
Czech Republic: Cernovicky brook	Czech Republic
Czech Republic: Dvoriste pond	Czech Republic
Czech Republic: Elbe River	Czech Republic
Czech Republic: Elbe River tributary	Czech Republic
Czech Republic: Libechovka brook	Czech Republic
Czech Republic: Luznice River	Czech Republic
Czech Republic: Novohaklovsky pond	Czech Republic
Czech Republic: Novohradsky pond	Czech Republic
Czech Republic: Rozmberk pond	Czech Republic
Czech Republic: Svet pond	Czech Republic
Czech Republic: Vysatov pond	Czech Republic
France:Bugey	France
France:Cattenom	France
France:Chooz	France
France:Dampierre	France
France:Golfech	France
French Southern and Antarctic Lands:Ile de la Possession	antarctica
Italy:Pisciarelli Solfatara	Italy
Japan: Osaka, Yodo River	Japan
Japan:Ishikawa, Kanazawa, Kanazawa university hospital	Japan
Japan:Osaka, Yodo River	Japan
Mexico:Distrito Federal	Mexico
Mexico:Estado de Mexico	Mexico
Mexico:Michoacan	Mexico
Norway:Spitzbergen	Norway
Pakistan: Chasada	Pakistan
Pakistan: Islamabad	Pakistan
Pakistan: Kheber Agency	Pakistan
Pakistan: Lahore	Pakistan
Pakistan: Peshawar	Pakistan
Pakistan: Rawlakot	Pakistan
Peru:Iquitos	Peru
Peru:Pantano Villa	Peru
Russia:Caldera Uzon, Kamchatka	Russia
Thailand: Bangkok market	Thailand
USA:Arizona, Apache Trail, Pine Creek	United States
USA:California	United States
USA:Scottsdale, Canal of Arizona	United States
American Samoa: Amalau, Tutuila	Samoa
American Samoa: Malaeimi Valley, Tutuila	Samoa
American Samoa: Tafuna, Tutuila	Samoa
Australia: Townsville	Australia
Bermuda	United Kingdom
Brazil: Brazilian Amazon	Brazil
Brazil: Estacao Ecologica de Aguas Emendadas, Distrito Federal	Brazil
Burma	Myanmar [Burma]
Cameroon: Mount Cameroon region	Cameroon
Chile: Ancud	Chile
Chile: Pantanillo	Chile
Chile: Punta Arenas	Chile
Chile: Rinconada	Chile
China: southern	China
Colombia: Rio Meta	Colombia
Comoros: Grand Comore	Comoros
Comoros: Moheli	Comoros
Equatorial Guinea: Bioko	Equatorial Guinea
Gabon: Makokou	Gabon
Ghana: Begoro, Eastern Region	Ghana
Ghana: Cape Coast, Central Region	Ghana
Ghana: Prampram, Greater Accra Region	Ghana
Ghana: Wa, Upper West Region	Ghana
Greece:Attiki	Greece
Greece:Lakonia	Greece
Greece:Larisa	Greece
Guinea: Papua New	Papua New Guinea
India: Orissa, Kandhaguda	India
India: Orissa, Koraput	India
India: Orissa, Malkangiri	India
India: Orissa, Tentulogund	India
India: Pondicherry, Vanrapet	India
India: Poondicherry, Poondicherry Town	India
India: Tamil Nadu, Chennai, Besant Nagar	India
India: Tamil Nadu, Chennai, Elephant Gate	India
India: Tamil Nadu, Rameswaram	India
India: Tamil Nadu, Ramnad	India
Indonesia: Central Java	Indonesia
Indonesia: Gag	Indonesia
Indonesia: Kalimantan	Indonesia
Indonesia: Legundi	Indonesia
Indonesia:Papua	Indonesia
Iran: Chabahar District	Iran
Iran: Sistan and Baluchistan province, Chabahar district	Iran
Japan: Kanagawa	Japan
Japan: Nagasaki, Tsushima	Japan
Japan: Niigata	Japan
Japan: Okinawa, Iriomote Island	Japan
Japan: Okinawa, Ishigaki Is.	Japan
Japan: Okinawa, Ishigaki Island	Japan
Japan:Fukuoka	Japan
Japan:Niigata	Japan
Japan:Shizuoka	Japan
Japan:Yamaguchi	Japan
Kenya: Kisii	Kenya
Malaysia: Borneo	Malaysia
Mauritius: Rodrigues	Mauritius
Mexico: Socorro Island	Mexico
Micronesia: Marianas	Micronesia
Micronesia: Northern Marianas	Micronesia
Myanmar: Shan, Bago, Mon	Myanmar [Burma]
Myanmar:Shan, Bago, Mon	Myanmar [Burma]
Papua New Guinea: Dawson Island	Papua New Guinea
Papua New Guinea: Hummock Island	Papua New Guinea
Papua New Guinea: Lowlands around Mt. Bosavi	Papua New Guinea
Papua New Guinea: Panapompom Island	Papua New Guinea
Sao Tome and Principe: Principe	Sao Tome and Principe
Sao Tome and Principe: Sao Tome	Sao Tome and Principe
Seychelles: Fregate	Seychelles
Seychelles: Praslin	Seychelles
South Korea: Bucheon-si	South Korea
South Korea: Cheorwon-gun	South Korea
South Korea: Gangwha-gun	South Korea
South Korea: Gimpo-si	South Korea
South Korea: Paju-si	South Korea
Spain: Canary Islands, La Palma Island	Spain
Spain: Canary Islands, Tenerife Island	Spain
Spain: Segovia	Spain
Thailand: Tak province	Thailand
USA: Northern California	United States
USA: Vermont	United States
USA: Washington, D.C., National Zoo	United States
USA:Hawaii: Alakai Wilderness Preserve	United States
USA:Hawaii: Volcanoes National Park	United States
United Kingdom: New Island, Falkland Islands	United Kingdom
United Kingdom: Wytham Woods, Oxfordshire	United Kingdom
Canada: Kugluktuk, Nunavut	Canada
India: New Delhi	India
Iran: Babol	Iran
Italy: Macomer (Nu), Sardinia	Italy
Japan:Hyougo	Japan
USA: Arkansas	United States
USA: Canon City, Freemont County, Colorado	United States
USA: Canon, Freemont, Colorado	United States
USA: Greenough, Missoula County, Montana	United States
USA: Greenough, Missoula, Montana	United States
USA: San Francisco	United States
Argentina: Corrientes	Argentina
Argentina: Rafaela	Argentina
Argentina: Salta	Argentina
Australia: Gatton, Queensland	Australia
Australia: NSW	Australia
Austria: Burgenland, Guessing	Austria
Canada: Saskatchewan	Canada
China: Guangdong	China
China: Hebei	China
China: Hunan	China
China: Inner Mengolia	China
China: Jinchang	China
China: Kashi	China
China: Kunming	China
China: Liaoyanng	China
China: Longde	China
China: Longjing	China
China: Lushi	China
China: Nanjing, Jiangsu	China
China: Ninxian	China
China: Nongan	China
China: Sanmenxia	China
China: Shanxian	China
China: Tianzhu	China
China: TouDao	China
China: Toudao	China
China: Weiyuan	China
China: Yanji	China
China: Yili	China
China: Yunnan Province	China
China:Nanjing	China
Denmark: Copenhagen	Denmark
France: Corsica	France
France: Drome	France
France: Haute-Garonne	France
France: Herault	France
Ghana:Accra	Ghana
Hungary: 20th district, Budapest	Hungary
Hungary: 21st district, Budapest J11	Hungary
Hungary: 21st district, Budapest J7	Hungary
Hungary: Balatonfenyves	Hungary
Hungary: Budapest K5	Hungary
Hungary: Csorna	Hungary
Hungary: Csorna, K10	Hungary
Hungary: Csorna, K11	Hungary
Hungary: Csorna, K9	Hungary
Hungary: Erd	Hungary
Hungary: Nyiregyhaza	Hungary
India: Andhra Pradesh, Deer Park, Karimnagar	India
India: Andhra Pradesh, Mahavir Harina Vanasthali National Park, Vanasthalipuram, Hyderabad	India
India: Andhra Pradesh, Nehru Zoological Park, Hyderabad	India
India: Andhra Pradesh, Reserve forest	India
India: Andhra Pradesh, Sri.Venkateswara Zoological park, Tirupati	India
India: Bareilly	India
India: Bihar, Patna Zoological Park, Patna	India
India: Hisar	India
India: Karnal	India
India: Ludhiana	India
India: West Bengal	India
Iran: Alborz	Iran
Japan: Chitose	Japan
Japan: Ikeda	Japan
Japan:Kagawa	Japan
Portugal: Aljustrel	Portugal
Portugal: Avis	Portugal
Portugal: Barrancos	Portugal
Portugal: Cartaxo	Portugal
Portugal: Coruche	Portugal
Portugal: Idanha-a-Nova	Portugal
Portugal: Monforte	Portugal
Portugal: Montemor-o-Novo	Portugal
Portugal: Mora	Portugal
Portugal: Santiago do Cacem	Portugal
Portugal: Tavira	Portugal
South Africa: Great Limpopo Transfrontier Park	South Africa
South Africa: Hluhluwe-Imfolozi Park	South Africa
South Africa: Hoedspruit	South Africa
South Africa: KwaZulu-Natal province	South Africa
Thailand:Central	Thailand
Thailand:Chiang Rai	Thailand
Thailand:North	Thailand
Thailand:Northeast	Thailand
USA: Eagle Pass, Texas	United States
USA: Gulf Port MS	United States
USA: Kansas	United States
USA: Mafalda, TX	United States
USA: Monica, TX	United States
USA: New Hampshire	United States
USA: Oklahoma	United States
USA: Ruby, TX	United States
USA: Southfield MI	United States
USA: Tennessee	United States
Viet Nam:Ha Noi	Vietnam
Canada: Merritt, BC	Canada
China: Guangxi	China
India:Jammu and Kashmir	India
Peru: Cuzco	Peru
Peru: Huancavelica	Peru
Peru: Puno	Peru
Poland: South-Eastern Poland	Poland
Russia: West Siberia (Altay)	Russia
Russia: West Siberia (Belovo)	Russia
Russia: West Siberia (Gornaya Shoria)	Russia
Russia: West Siberia (Guryevsk)	Russia
Russia: West Siberia (Kouznetskiy Alatau)	Russia
Russia:West Siberia (Altay)	Russia
Russia:West Siberia (Belovo)	Russia
Russia:West Siberia (Gornaya Shoria)	Russia
Russia:West Siberia (Guryevsk)	Russia
Russia:West Siberia (Kouznetskiy Alatau)	Russia
USA: Ann Arbor, MI	United States
USA: Raco, MI	United States
United Kingdom: Scotland	United Kingdom
United Kingdom: Wales	United Kingdom
Argentina: 30 de Agosto, Buenos Aires	Argentina
Argentina: Arias, Cordoba	Argentina
Argentina: Balcarce, Buenos Aires	Argentina
Argentina: Carmen de Areco, Buenos Aires	Argentina
Argentina: Castellanos, Santa FE	Argentina
Argentina: Castellanos, Santa Fe	Argentina
Argentina: General Lopez, Santa Fe	Argentina
Argentina: General Rivadavia, Buenos Aires	Argentina
Argentina: Lincoln, Buenos Aires	Argentina
Argentina: Olavarria, Buenos Aires	Argentina
Argentina: Pila, Buenos Aires	Argentina
Argentina: Rafaela Santa Fe	Argentina
Argentina: Rafaela, Santa Fe	Argentina
Argentina: Saliquello, Buenos Aires	Argentina
Argentina: San Justo, Cordoba	Argentina
Argentina: Tres Lomas, Buenos Aires	Argentina
Brazil: Lage Preta-Muriqui	Brazil
Brazil: Praia do Saco-Muriqui	Brazil
China: Lingshan	China
China: Yunnan, Lincang	China
China: Yunnan, Menglian	China
China: Yunnan, Zhenyuan	China
Iran: Amol	Iran
Japan: Hokkaido, Ishikari district	Japan
Norway: Vestfold county	Norway
Philippines: Calauan, Laguna, Luzon	Philippines
Philippines: Los Banos, Laguna, Luzon	Philippines
United Kingdom: Liverpool	United Kingdom
United Kingdom: St. Kilda	United Kingdom
Australia: Central Australia, Northern Territory	Australia
Australia: Gascoyne, Western Australia	Australia
Australia: Goldfields, Western Australia	Australia
Australia: Kimberley, Western Australia	Australia
Australia: Mid West, Western Australia	Australia
Australia: Peel, Western Australia	Australia
Australia: Perth, Western Australia	Australia
Australia: Pilbara, Western Australia	Australia
Canada: British Columbia	Canada
Egypt: Kafr El Sheikh Province	Egypt
Norway: Bikkajavrret	Norway
Norway: Carajavrret	Norway
Norway: Fjellfrosk	Norway
Norway: Koifjordvatnet	Norway
Spain: Canary Island, El Hierro	Spain
Spain: Canary Island, Fuerteventura	Spain
Spain: Canary Island, Gran Canaria	Spain
Spain: Canary Island, La Gomera	Spain
Spain: Canary Island, La Palma	Spain
Spain: Canary Island, Lanzarote	Spain
Turkey:Trakya	Turkey
Brazil: Uberaba	Brazil
China: Tibet, Mila East Slope	China
China: Tibet, Mila Mountaintop	China
China: Tibet, Mila West Slope	China
Italy: Sardinia	Italy
Japan: Hyogo, Kobe	Japan
Japan: Kanazawa, Kanazawa Medical University	Japan
Japan: Kanazawa, Kanazawa National Institutes of Infectious Diseases (NIID)	Japan
Japan: Kanazawa, Kanazawa University Hospital	Japan
Netherlands: Veluwe	Netherlands
African Country	africa
Argentina: Mendoza province	Argentina
Australia: Bald Isoland, Western Australia	Australia
Australia: Rottnest Island, Western Australia	Australia
Australia: Tow People Bay, Western Australia	Australia
Brazil:Marica	Brazil
Brazil:Rio Bonito	Brazil
Brazil:Rio Bonito,Brazil:Marica	Brazil
Costa Rica 	Costa Rica
Guadeloupe Island	asia
Svalbard	Norway
China: Changchun, Jilin	China
China: Harbin, Heilongjiang	China
China: Shenyang, Liaoning	China
Democratic Republic of the Congo: Kinshasa	Democratic Republic of the Congo
Indonesia: Sumba Island	Indonesia
Mexico: Centro Nacional de Clinica de Displasias del Hospital General de Mexico	Mexico
Poland:Warsaw	Poland
United Kingdom: South Yorkshire	United Kingdom
Brazil: Cuiaba	Brazil
Brazil: Macapa	Brazil
Brazil: Puerto Velho	Brazil
Cameroon: Bertoua, East Region	Cameroon
Cameroon: Douala, Littoral Region	Cameroon
Cameroon: Ebolowa	Cameroon
Cameroon: Ebolowa, South Region	Cameroon
Cameroon: Yaounde, Centre Region	Cameroon
Cameroon:Centre Region, Yaounde	Cameroon
Cameroon:East Region, Bertoua	Cameroon
Cameroon:Littoral Region, Douala	Cameroon
Cameroon:South Region, Ebolowa	Cameroon
China: Yunnan province	China
China: Yunnan province near China-Myanmar border	China
China: Zhejiang province	China
Colombia: Buenaventura	Colombia
India: Arunachal Pradesh	India
India: Asom	India
India: Assam, Udalguri	India
India: Gujarat	India
India: Odisha	India
Indonesia: Lombok	Indonesia
Indonesia: South Kalimantan	Indonesia
Madagascar: West	Madagascar
Madagascar: highland	Madagascar
Malaysia: Johor	Malaysia
Malaysia: Kelantan	Malaysia
Malaysia: Negeri Sembilan	Malaysia
Malaysia: Pahang	Malaysia
Malaysia: Peninsular Malaysia	Malaysia
Malaysia: Selangor	Malaysia
Malaysia: Terengganu	Malaysia
Mexico: Cacahoatan, Chiapas, Parcela Union Roja	Mexico
Mexico: Suchiate, Chiapas, Ejido Cozalapa	Mexico
Mexico: Tapachula, Chiapas, Canton San Francisco	Mexico
Mexico: Tapachula, Chiapas, Ejido Chespal Nuevo	Mexico
Mexico: Tapachula, Chiapas, Ejido La Concordia	Mexico
Mexico: Tapachula, Chiapas, El Retiro II	Mexico
Mexico: Tapachula, Chiapas, Fraccion Los Angeles, Carrillo Puerto	Mexico
Mexico: Tapachula, Chiapas, La Concordia	Mexico
Mexico: Tapachula, Chiapas, Rancheria El Manguito	Mexico
Mexico: Tapachula, Chiapas, Rancheria Santa Rita	Mexico
Mexico: Tapachula, Chiapas, Tapachula City	Mexico
Mexico: Tuxtla Chico, Chiapas, 1a Seccion de Guillen	Mexico
Pakistan: Karachi	Pakistan
Pakistan: Sindh	Pakistan
Peru: Padre Cocha-Loreto Province	Peru
Peru: San Juan-Loreto Province	Peru
Russia: Kaliningrad	Russia
Russia: Kaliningrad obl.	Russia
Russia: Kaliningradskaya obl.	Russia
Thailand: Ranong	Thailand
Thailand: Yala	Thailand
Thailand:Chaiyaphumi, Nakornsawan	Thailand
Thailand:Chiangmai	Thailand
Thailand:Kanchanaburi	Thailand
Thailand:Kanchanaburi Province	Thailand
Thailand:Ratchaburi	Thailand
Thailand:Saraburi	Thailand
Thailand:Tak	Thailand
Vanuatu: Ambae island	Vanuatu
Vanuatu: Aneityum island	Vanuatu
Vanuatu: Gaua island	Vanuatu
Vanuatu: Malakula island	Vanuatu
Vanuatu: Pentecost island	Vanuatu
Vanuatu: Santo island	Vanuatu
Vanuatu: Tanna island	Vanuatu
Venezuela: Tumeremo-Bolivar State	Venezuela
Argentina: Esteros del Ibera	Argentina
Argentina: Pampa del Indio, Chaco	Argentina
Bangladesh: Chittagong	Bangladesh
Brazil: Amazon	Brazil
Brazil: Bahia, BA	Brazil
Brazil: Brazil	Brazil
Brazil: Ceara, CE	Brazil
Brazil: Distrito Federal, DF	Brazil
Brazil: Mato Grosso do Sul, MS	Brazil
Brazil: Mato Grosso do Sul, MT	Brazil
Brazil: Mato Grosso, MT	Brazil
Brazil: Mossoro-RN	Brazil
Brazil: Para, PA	Brazil
Brazil: Parana, PR	Brazil
Brazil: Pernambuco, PE	Brazil
Brazil: Piaui, PI	Brazil
Brazil: Pinheiros, ES	Brazil
Brazil: Rio Grande do Sul, RS	Brazil
Brazil: Rio de Janeiro, RJ	Brazil
China: Wenchuan, Sichuan	China
Ethiopia: Wollo	Ethiopia
India: Aamala, Thiruvananthapuram District, Kerala	India
India: Kombidi, Thiruvananthapuram District, Kerala	India
India: Meleamala, Thiruvananthapuram District, Kerala	India
India: Thazheamala, Thiruvananthapuram District, Kerala	India
Iran: Alborz Province, Savodjbolagh	Iran
Iran: Alborz Province, Savodjbolagh County	Iran
Iran: Alborz province, Savodjbolagh county, Arab-Abad village	Iran
Iran: Ardebil province, North-West of Iran	Iran
Iran: Birjand	Iran
Iran: Esfarayen	Iran
Iran: Esfarayen district	Iran
Iran: Farashband	Iran
Iran: Ilam province	Iran
Iran: Ilam province, Abdanan	Iran
Iran: Ilam province, Dasht-e-Abbas	Iran
Iran: Ilam province, Dehloran	Iran
Iran: Ilam province, Mehran	Iran
Iran: Ilam province, Moosian	Iran
Iran: Isfahan Province, Kashan city	Iran
Israel: Maale Adumim	Israel
Mexico: Sonora	Mexico
Mozambique: Gorongosa	Mozambique
Taiwan: Hsinchu	Taiwan
Thailand: Songkhla	Thailand
Turkey: Adana	Turkey
USA: Captain Cook, HI	United States
USA: Davis, CA	United States
USA: Starr Co., TX	United States
USA: Stony Brook, NY	United States
USA: Waimanu, HI	United States
USA: Winters, CA	United States
Turkey: Afyon	Turkey
Turkey: Kutahya	Turkey
Turkey: Mersin	Turkey
Turkey: Nigde	Turkey
USA	United States
Taiwan: R.O.C.	Taiwan
Belarus: Naroch Lake	Belarus
Brazil: Belem, Para, long term lab isolate Lygia R. Correa	Brazil
Brazil: CMO, Ceara-Mirim, Rio Grande del Norte, long term lab isolate Lygia R. Correa	Brazil
Brazil: Corrego de Cafe	Brazil
Brazil: Dionisio, Minas Gerais	Brazil
Brazil: Recife, Pernambuco	Brazil
Brazil: Sabara, Minas Gerais	Brazil
Brazil: Sao Jose dos Campos, Sao Paulo state	Brazil
Brazil: Sumidouro, Rio de Janeiro	Brazil
Burundi: Maintained in Natural History Museum, London	Burundi
Cambodia: Lumphat, Srepok River	Cambodia
Cambodia: Sadao, Stung-Treng Province, Xe Kong River	Cambodia
Cambodia: Sadao, Xe Kong River, Stung-Treng Province	Cambodia
Cameroon:Edea	Cameroon
China: Anhui Guichi	China
China: Anhui Province, Guichi County	China
China: Anhui Province, Tongling County	China
China: Anhui Province, Zongyang County	China
China: Anhui, Guichi	China
China: Anhuil, Guichi	China
China: Changsha, Hunan	China
China: Dali, Yunnan	China
China: Eryuan, Yunnan	China
China: Guichi, Anhui	China
China: Hubei Province, Gong'an County	China
China: Hubei Province, Honghu City	China
China: Hubei Province, Jinzhou City	China
China: Hubei Province, Pengze County	China
China: Hubei Province, Qianjiang City	China
China: Hubei Province, Wuhan City	China
China: Hubei Province, Yangxin County	China
China: Hubei Wuhan	China
China: Hubei province	China
China: Hubei, Wuhan	China
China: Hunan Changsha	China
China: Hunan Province, Huarong County	China
China: Hunan Province, Lixian County	China
China: Hunan Province, Xiangyin County	China
China: Hunan Yuyanglou distrit	China
China: Hunan junshan	China
China: Hunan province	China
China: Hunan, Changde	China
China: Hunan, Changsha	China
China: Hunan, Junshan	China
China: Hunan, Miluo	China
China: Hunan, Yueyanglou	China
China: Hunan, Yueyanglou district	China
China: Jiangsu Province, Zhenjiang City	China
China: Jiangsu Wuxi	China
China: Jiangsu, Wuxi	China
China: Jiangxi Province, Pengze County	China
China: Jiangxi Province, Xinjian County	China
China: Jiangxi Yongixiu	China
China: Jiangxi province	China
China: Jiangxi, Yongxiu	China
China: Jiangxi, yongxiu	China
China: Jiansu, Wuxi	China
China: Jiaxing, Zhejiang	China
China: Junshan, Hunan	China
China: Maoshan, Sichuan	China
China: Mianzhu District, Sichuan Province	China
China: Mianzhu, Sichuan	China
China: Sichuan Province, Xichang City	China
China: Sichuan, Maoshan	China
China: Sichuan, Tianquan	China
China: Sichuan, Xichang	China
China: Tianquan, Sichuan	China
China: Xichang, Sichuan	China
China: Xichuan Maoshan	China
China: Xichuan Tianquan	China
China: Xichuan Xichang	China
China: Xizhou, Yunnan	China
China: Yongsheng, Yunnan	China
China: Yongxiu, Jiangxi	China
China: Yueyanglou, Hunan	China
China: Yunan, Eryuan	China
China: Yunan, EryuanII	China
China: Yunnan Eryuan I	China
China: Yunnan Eryuan II	China
China: Yunnan Province, Eryuan County	China
China: Yunnan Province, Heqing County	China
China: Yunnan, Eryuan	China
China: Zhejiang Jiashan	China
China: Zhejiang, Jiashan	China
China: Zhejiang, Jiaxing	China
China:Changsha, Hunan province	China
China:Hei Longjiang Provience	China
China:Yueyang, Hunan Province	China
China:Yueyang, Hunan province	China
Democratic Republic of the Congo:Kinshasa	Democratic Republic of the Congo
Egypt: Alzahraa, Kafr El Sheikh Governorate	Egypt
Egypt: Mansafire, Menia Governorate	Egypt
Egypt: Menia Governorate, Upper Egypt	Egypt
Egypt: NIAID maintained	Egypt
Egypt: long term lab isolate SSCP supplies	Egypt
France: Annecy Lake	France
France: Beauvais	France
France: Der-Chantecoq Lake	France
France: Marne	France
France: Marne, Der-La Cornue	France
France: Marne, Der-Larzicourt	France
France: Strasbourg	France
Ghana: Accra	Ghana
Guadeloupe	Guadeloupe
Guadeloupe: DFO, Grand-Terre	Guadeloupe
Guadeloupe: Grand Camp, Basse-Terre	Guadeloupe
Iceland: Botnsvatn	Iceland
Iceland: Botsvatn Lake	Iceland
Iceland: Helgavogur-Myvatn	Iceland
Iceland: Raudavatn	Iceland
Iran: Ahwaz, Khuzestan province	Iran
Iran: Fereydoon Kenar	Iran
Iran: Khuzestan	Iran
Iran: Sari	Iran
Iran:Sari	Iran
Japan: Yamanashi	Japan
Kenya: ADC Farms, Kisumu	Kenya
Kenya: Adupe, Lake Victoria	Kenya
Kenya: Asao Stream	Kenya
Kenya: Asembo Bay, Lake Victoria	Kenya
Kenya: Car Wash, Kisumu, Lake Victoria	Kenya
Kenya: Coastal Kenya	Kenya
Kenya: Homa Bay	Kenya
Kenya: Homa Bay, Lake Victoria	Kenya
Kenya: Kagwell Beach, Lake Victoria	Kenya
Kenya: Kalina Koi, Kibwezi	Kenya
Kenya: Kasabong Stream	Kenya
Kenya: Kisukioni	Kenya
Kenya: Kisumu	Kenya
Kenya: Kisumu, Powerhouse, Lake Victoria	Kenya
Kenya: Kisumu, Tilapia Beach, Lake Victoria	Kenya
Kenya: Kitui Town	Kenya
Kenya: Kuoyo, Lake Victoria	Kenya
Kenya: Kwale	Kenya
Kenya: Lwanda Stream	Kenya
Kenya: Machakos Town, Musilili stream	Kenya
Kenya: Makueni, Makindu Town	Kenya
Kenya: Maralal	Kenya
Kenya: Mata village, Taveta	Kenya
Kenya: Mathoungouta, Mwea	Kenya
Kenya: Mazeras	Kenya
Kenya: Mtito River	Kenya
Kenya: Nandi	Kenya
Kenya: Narok	Kenya
Kenya: Nawa, Lake Victoria	Kenya
Kenya: Near Machakos, Mwanyani River	Kenya
Kenya: Nyabera	Kenya
Kenya: Nyabera marsh near Kisumu	Kenya
Kenya: Seka Kagwa, Lake Victoria	Kenya
Kenya: Usare Beach, Lake Victoria	Kenya
Kenya: Wistima, Lake Victoria	Kenya
Kenya: coastal region	Kenya
Laos: Ban Hat-Xai-Khoun, Champassac Province, Mekong River	Laos
Laos: Ban Hat-Xai-Khoun, Mekong River, Champassac Province	Laos
Laos: Khong Island	Laos
Madagascar: Antsirabe	Madagascar
Madagascar: Ihosy	Madagascar
Madagascar: Mananjary Town	Madagascar
Malaysia: Baling	Malaysia
Malaysia: Baling, Kedah State	Malaysia
Mali: Bamako, Farako River	Mali
Philippines: Asuncion	Philippines
Philippines: Asuncium	Philippines
Philippines: Letye	Philippines
Philippines: Leyte	Philippines
Philippines: Mindoro	Philippines
Philippines: Sorsogon	Philippines
Philippines: Sorsogor	Philippines
Puerto Rico: Caguas Valley	Puerto Rico
Puerto Rico: PR1 long term lab isolate Eric S. Loker	Puerto Rico
Russia: Moscow, Altufevo Ponds	Russia
Russia: Moscow, Altufyevo ponds	Russia
Russia: Moscow, Lianozovo ponds	Russia
Russia: Moscow, Olympijskaja Derevnja Ponds	Russia
Russia: Moscow, Olympiyskaya derevnya ponds	Russia
Russia: Moscow, Putyaevo ponds	Russia
Russia: Moscow, Tsaritsino ponds	Russia
Russia: Westen Siberia, Kargat River	Russia
Russia: Western Siberia, Novosibirsk region, Kargat River	Russia
Sao Tome and Principe:San Antonio	Sao Tome and Principe
Senegal: Richard Toll, Ndiangue	Senegal
Senegal: Richard Toll, Ndombo	Senegal
Senegal: Upper Senegal River Basin	Senegal
Senegal:Mbodiene	Senegal
Senegal:Sintiou Malem	Senegal
Senegal:St Louis	Senegal
Tanzania: Kaseni-Shuleni, Ukerewe Is, Lake Victoria	Tanzania
Tanzania: Kimamba, Darangani, Ilula Town	Tanzania
Tanzania: Lake Victoria	Tanzania
Tanzania: Mafia Island	Tanzania
Tanzania: Mwanza, Mirongo stream	Tanzania
Tanzania: Nansio, Ukerewe Is, Lake Victoria	Tanzania
Tanzania: Tunduma, Safisha stream	Tanzania
Tanzania: Zanzibar	Tanzania
Thailand: Chiang-Mai	Thailand
Thailand: Khon-Kaen	Thailand
Thailand: Phitsanulok	Thailand
Uganda: Kimi Island	Uganda
Uganda: Kimi Island, Lake Victoria	Uganda
Uganda: Lake Albert	Uganda
Uganda: Ngamba Island, Lake Victoria	Uganda
Uganda: Ssesse Islands	Uganda
United Kingdom: England, Hampshire	United Kingdom
Venezuela: long term lab isolate Italo M. Cesari	Venezuela
Venezuela: long term lab isolate R. Nino Incani	Venezuela
Zambia: Kariba Dam	Zambia
Zambia:Denwood	Zambia
Antarctica: Antarctic Peninsula	antarctica
Antarctica: Ardery Island	antarctica
Antarctica: Ardley Island	antarctica
Antarctica: Bose Jubony, Isla 25 da Mugo, Shetland del Sur	antarctica
Antarctica: Cape Crozier, Ross Is.	antarctica
Antarctica: Dry Valley	antarctica
Antarctica: Marble Pt. near air facility, Ross Sea	antarctica
Antarctica: Prydz Bay	antarctica
Antarctica: Ross Sea	antarctica
Antarctica: Sea of Okhotsk	antarctica
Antarctica: Western Antarctica, South Shetland Archipelago, Livingston Island, Bulgarian Antarctic Base St. Kliment Ohridski	antarctica
Antarctica: ornithogenic soils in penguin colony areas, Windmill Islands	antarctica
Antarctica: penguin colony areas, Windmill Islands	antarctica
Argentina: Anchoris, Lujan, Mendoza	Argentina
Argentina: Andrade, Rivadavia, Mendoza	Argentina
Argentina: Balcarce, Buenos Aires province	Argentina
Argentina: Chubut	Argentina
Argentina: Cordoba	Argentina
Argentina: La Blanca, Maipu, Mendoza	Argentina
Argentina: La Holanda, Lavalle, Mendoza	Argentina
Argentina: LasYungas foothills, Pedemontana forest	Argentina
Argentina: Lavalle, Mendoza	Argentina
Argentina: Patagonia	Argentina
Argentina: Pocito, San Juan	Argentina
Argentina: Tandil, Buenos Aires province	Argentina
Argentina: Villa Aberastain, Pocito, San Juan	Argentina
Argentina: Vistalba, Lujan, Mendoza	Argentina
Argentina:Alberto Roth botanical garden	Argentina
Argentina:Iguazu National Park	Argentina
Argentina:Misiones Province	Argentina
Australia: Alfred Hospital Victoria Melbourne Microbiology Unit Clave Franklin tel (03) 90763295	Australia
Australia: Australian Cotton Research Institute	Australia
Australia: Botany Bay, Sydney	Australia
Australia: Box Hill Hospital, Melbourne, VIC	Australia
Australia: Brigalow Nature Reserve	Australia
Australia: CSIRO	Australia
Australia: Food Science Australia	Australia
Australia: Jack's Creek State Forest	Australia
Australia: MacIntyre valley	Australia
Australia: Melbourne, VIC	Australia
Australia: Midkin Nature Reserve	Australia
Australia: NSW, Cherrybrook	Australia
Australia: Namoi valley	Australia
Australia: Orange Grove Cotton Farm	Australia
Australia: Queensland, Atherton	Australia
Australia: Queensland, Baron Falls	Australia
Australia: Queensland, Barrie Lake	Australia
Australia: Queensland, Barron Falls	Australia
Australia: Queensland, Bli Bli, Maroochy Wetlands	Australia
Australia: Serology Department RMH Grattan St Parkville VIC 3050 tel 9342-8942	Australia
Australia: St. George valley	Australia
Australia: Sydney, NSW	Australia
Australia: between Brisbane (27 degrees S) and Sydney (34 degrees S)	Australia
Australia:Melbourne	Australia
Australia:NSW	Australia
Australia:Sydney	Australia
Austria: Klausenleopoldsdorf	Austria
Austria: Lower Austria:Klausenleopoldsdorf	Austria
Austria: Maissau	Austria
Austria: Niederschleinz	Austria
Austria: Purkersdorf	Austria
Austria: Redlschlag	Austria
Austria: Riederberg	Austria
Austria: Tulln	Austria
Austria: Tyrol:Achenkirch	Austria
Belgium: Kaulile	Belgium
Brazil: Foz do Iguacu, Parana	Brazil
Brazil: Jaboticabal, SP	Brazil
Brazil: Nova Petropolis	Brazil
Brazil: Paranagua Bay, Parana	Brazil
Brazil: Parque Estadual da Mata Seca , Manga, MG	Brazil
Brazil: Pernambuco	Brazil
Brazil: Pernambuco st.	Brazil
Brazil: Sao Pablo, SP	Brazil
Brazil: Sao Paul, Institute of Tropical Medicine	Brazil
Brazil: Seropedica, RJ	Brazil
Brazil: Ubarana, Sao Paulo	Brazil
Brazil:Pernembuco state	Brazil
Brazil:Sao Paulo State, Botucatu	Brazil
Bulgaria: Pudria	Bulgaria
Bulgaria: Stora, Zagora	Bulgaria
Bulgaria: Viatsa	Bulgaria
Cambodia: Siem Reap	Cambodia
Canada: Alberta	Canada
Canada: Calgary, Alberta	Canada
Canada: Five Islands Provincial Park in Nova Scotia	Canada
Canada: High-Arctic	Canada
Canada: Manitoba	Canada
Canada: Niagara Falls	Canada
Canada: Ontario, Niagara, Niagara Falls, Fireman's Park	Canada
Canada: Quebec	Canada
Canada: Wallaceburg, ON	Canada
Canada: Wallaceburg, Ontario	Canada
China: Baimaxueshan National Natural Reserve in Yunnan Province	China
China: Beijing Tongzhou	China
China: Beijing region	China
China: Benxi Steel Coking plant	China
China: Bohai Sea (Binzhou City)	China
China: Chengdu, Sichuan	China
China: Chongqing, Jinyun Mountain	China
China: Da Qiao	China
China: Dafeng Harbor, Yancheng, Jiangsu Province	China
China: Dalian	China
China: Dalian, Liaoning	China
China: Dinghu Mountain Biosphere Reserve, Guangdong	China
China: Dongxiang, Jiangxi	China
China: Fangcheng county, Henan province	China
China: Fujian coast	China
China: Fujian province, Xiamen city	China
China: Fujian, Xiamen	China
China: Fuzhou, Fujian Normal University	China
China: Golden Camellia National Natural Reserve in Guangxi Zhuang Autonomous Region	China
China: Guangdong province, Puning	China
China: Guangdong, Dongzhaigang	China
China: Guangdong, Shantou	China
China: Guangxi Botanical Garden of Medicinal Plants	China
China: Guangxi, Shankou	China
China: Guanzaishan Garden, Fujian Province	China
China: Guizhou	China
China: Guizhou Province Guiyang Kaiyang	China
China: Gunagxi	China
China: Gurbantunggute desert	China
China: Haikou	China
China: Haikou, Hainan	China
China: Hainan Dongzhai National Nature Reserve	China
China: Hainan Island, Xin Ying	China
China: Hainan, Wenchang	China
China: Hanlian	China
China: Harbin	China
China: Hebei province, Laiyuan county	China
China: Heilongjiang	China
China: Heilongjiang Province	China
China: Huaping National Natural Reserve in Guangxi Zhuang Autonomous Region	China
China: Hubei, Liuyang	China
China: Huiquan Bay, Qingdao	China
China: Hunan,Changsha	China
China: Jiangsu Province, Dafeng harbor in the city of Yancheng	China
China: Jiangsu, Taihu Lake, Xishan Island	China
China: Jiangsu, Yancheng, Dafeng harbor	China
China: Jiangxi province, Jinggang Shan	China
China: Jiangxi province, Lushan Mountain	China
China: Jiao Zhou Bay, Qingdao	China
China: Jilin province	China
China: Jinghong, Xishuangbanna, Yunnan	China
China: Jinhua, Zhejiang Province	China
China: Jining	China
China: Kunming Institute of Botany	China
China: Laohugou no. 12 glacier, Qilian Mountain, Tibetan Plateau	China
China: Liangshui National Natural Reserve in Heilongjiang Province	China
China: Liaoning, Dalian	China
China: Lin'an, Zhejiang Province	China
China: Longgang National Natural Reserve in Guangxi Zhuang Autonomous Region	China
China: Menghai County, Yunnan Province	China
China: Min Xian, Gan Su	China
China: Mogao Grottoes, Dunhuang	China
China: Nanjing, Jiangsu Province	China
China: Nanning, Guangxi Province	China
China: National Nature Reserve	China
China: North Yellow Sea	China
China: Northeast of Merzhou	China
China: Panan, Zhejiang Province	China
China: Ping Sea	China
China: Pudong, Shanghai	China
China: Puning, Guangdong	China
China: Qilian mountains	China
China: Qinghai Lake, Xining	China
China: Qinghai Province	China
China: Qinghai province	China
China: Qinghai-Tibet Plateau	China
China: Rongchang County, Chongqing City	China
China: Sanya Bay, South China Sea, Hainan Province	China
China: Sanya, Guangdong	China
China: Sanya, Hainan	China
China: Shaanxi	China
China: Shaanxi province	China
China: Shaanxi, museum garden, Northwest A&F University	China
China: Shankou Mangrove National Natural Reserve in Guangxi Zhuang Autonomous Region	China
China: Shankou Mangrove National Nature Reserve, Guangxi Province	China
China: Shanxi Province	China
China: Shanxi province	China
China: Shenyang Wild Animal Zoo	China
China: Shenzhen Mangrove Nature Reserve	China
China: Shiwandashan National Natural Reserve in Guangxi Zhuang Autonomous Region	China
China: Sichuan, Mianyang	China
China: Siping	China
China: Songhua River, Northeast China	China
China: South China Sea	China
China: South China Sea, Hainan	China
China: Taixing	China
China: Turpan, XinJiang	China
China: Weizhou Island, South China Sea	China
China: Weizhou coral reef, South China Sea	China
China: Whenzhou, Puqi Zhen fishery works	China
China: Wuhan	China
China: XiangXi Autonomy Region of the National Secondary Forest Nature Conservation Zone, Hunan	China
China: Xinjiang province	China
China: Xisha Islands, South China Sea	China
China: Xisha islands	China
China: Xishuangbanna National Natural Reserve in Yunnan Province	China
China: Xu XianXiu's tomb, Taiyuan	China
China: Yancheng Biosphere Reserve, Jiangsu Province	China
China: Yantai, Shandong	China
China: Yellow Sea	China
China: Yuelu Mountain, Hunan province	China
China: Yuexi County, Anhui Province	China
China: Yunnan province, north-western	China
China: Zhanjiang	China
China: Zhejiang Province, Jinyun County	China
China: Zhejiang, Yueqing	China
China: Zhengzhou	China
China: Zhoushan Island, marine culture zone	China
China: Zhuhai	China
China: Zhuzhou	China
China: east Asia monsoon region	China
China: farm near Wuhan city	China
China: intertidal zone of the Bohai Bay, next to Liaoning Province	China
China: mouth of Pearl River	China
China: north-western China, Yunnan province, Baoshan	China
China: southwestern China	China
China: suburb of Fangchenggang City in Guangxi Zhuang Autonomous Region	China
China: suburb of Jining	China
China:Beijing	China
China:East Pacific Ocean	China
China:Gansu,Lanzhou	China
China:Guangdong Province	China
China:Hangzhou	China
China:Hubei	China
China:Northern Tarim River basin Xinjiang Province	China
China:Songhua River	China
China:West Pacific Ocean	China
China:WestPacific Ocean	China
China:Wuhan, Oil Crops Research Institute of the Chinese Academy of Agricultural Sciences	China
China:Zhejiang Province	China
Colombia: AMU Chaparral, Cuernavaca farm, Paratebueno, Cundinamarca	Colombia
Colombia: AMU Porin, Santa Barbara land, Cumaral, Meta	Colombia
Colombia: Bogota	Colombia
Costa Rica: Las Alturas	Costa Rica
Costa Rica: Santa Rosa, Area de Conservacion Guanacaste	Costa Rica
Costa Rica:Taboga Island	Costa Rica
Cuba: Cuban Institute for Cinematographic Industry and Arts	Cuba
Czech Republic: Bohemian Forest NP	Czech Republic
Czech Republic: Libice nad Cidlinou, site Alb	Czech Republic
Czech Republic: Milovice, site H1	Czech Republic
Czech Republic:Albertam	Czech Republic
Czech Republic:Benesov	Czech Republic
Czech Republic:Bohemian Forest NP	Czech Republic
Czech Republic:Brno	Czech Republic
Czech Republic:Ceske Budejovice	Czech Republic
Czech Republic:Cheb, National Natural Reserve Soos	Czech Republic
Czech Republic:Chocenicka Lhota near Plzen	Czech Republic
Czech Republic:Chvaletice	Czech Republic
Czech Republic:Dolni Benesov	Czech Republic
Czech Republic:Doutnac hill near Srbsko, Bohemian Karst	Czech Republic
Czech Republic:Hradec Kralove	Czech Republic
Czech Republic:Hustopece	Czech Republic
Czech Republic:Kostomlaty nad Labem	Czech Republic
Czech Republic:Kutna Hora	Czech Republic
Czech Republic:Lazne Belohrad	Czech Republic
Czech Republic:Liberec	Czech Republic
Czech Republic:Louny	Czech Republic
Czech Republic:Markovicky near Kutna Hora	Czech Republic
Czech Republic:Melnik	Czech Republic
Czech Republic:Moravian Karst	Czech Republic
Czech Republic:Most	Czech Republic
Czech Republic:Most brown lignite district	Czech Republic
Czech Republic:National Nature Monument Jecmeniste	Czech Republic
Czech Republic:National Nature Monument U Kaplicky, Hosteradice	Czech Republic
Czech Republic:National Reservation Pouzdranska step Kolby	Czech Republic
Czech Republic:Nymburk	Czech Republic
Czech Republic:Olomouc	Czech Republic
Czech Republic:Ostrava	Czech Republic
Czech Republic:Pardubice	Czech Republic
Czech Republic:Plzen	Czech Republic
Czech Republic:Poibram	Czech Republic
Czech Republic:Polanka	Czech Republic
Czech Republic:Pribram	Czech Republic
Czech Republic:Ralsko	Czech Republic
Czech Republic:Ricany	Czech Republic
Czech Republic:Velke Losiny	Czech Republic
Czech Republic:Western Bohemia, National Natural Reserve So	Czech Republic
Czech Republic:Western Bohemia, National Natural Reserve Soos	Czech Republic
Czech Republic:Zlin	Czech Republic
Czech Republic:gallery in the quarry Mala	Czech Republic
Czech Republic:gallery in the quarry Mala Amerika	Czech Republic
Denmark: Farum	Denmark
Denmark: Lyngby	Denmark
Denmark: Sealand	Denmark
Egypt: 40 km from Cairo	Egypt
Egypt: Assiut Governorate, Sahel-Saleem city	Egypt
Egypt: Assiut, Sahel-Saleem	Egypt
Egypt: Beni Suef, New Beni Suef city	Egypt
Egypt: Damietta	Egypt
Egypt: El Mahala El Koubra	Egypt
Egypt: Giza	Egypt
Egypt: Hurghada	Egypt
Egypt: Kafr El Dawar	Egypt
Egypt: Minufyia	Egypt
Egypt: Rass Sedr	Egypt
Egypt: Saint Katherine protectorate	Egypt
Egypt: Shoubria	Egypt
Egypt: Suez Canal, 30 km N of Port Said, Sinai Peninsula	Egypt
Egypt: Zagazig City, Al-Sharqia Province	Egypt
Egypt: Zagazig University, Zagazig, Al-Sharqia Province	Egypt
Egypt:Beheira	Egypt
Egypt:Beni Suef	Egypt
Egypt:Gharbia	Egypt
Egypt:Giza	Egypt
Egypt:Kafr el-Sheikh' 2013 El sayed Shaban & S. Abdel Ghany	Egypt
Egypt:Monufia	Egypt
Ethiopia: Addis Abeba	Ethiopia
Finland: Oulu	Finland
Finland:central Finland	Finland
France: Guadeloupe	France
France:Europa Island	France
France:Montignac, Lascaux Cave	France
Germany: Berchtesgaden	Germany
Germany: Giessen	Germany
Germany: Kiel	Germany
Germany:Berlin	Germany
Germany:Braunschweig	Germany
Germany:City of Greifswald, nature conservation area Elisenhain	Germany
Germany:Dortmund, Rombergpark	Germany
Germany:Hesse: Kranichsteiner Wald	Germany
Germany:Mecklenburg-Western Pomerania, Greifswald, nature conservation area Elisenhain	Germany
Germany:North Sea around the island of Helgoland	Germany
Germany:Rostock	Germany
Germany:Weissagker Berg near Cottbus, Lusatian brown lignite district	Germany
Greece: Lesvos, Mytilini beach	Greece
Greenland: Fortune Bay, Disco Island	Greenland
Hungary: Bugac	Hungary
Hungary: Fulophaza	Hungary
Hungary: Tatarszentgyorgy	Hungary
India: Ahmedabad	India
India: Ajivali Sacred Grove	India
India: Allepey district, Kerala	India
India: Amirthi Forest Area, Vellore, Tamil Nadu	India
India: Amlakhadi, Bharuch, Gujrat	India
India: Andaman Isiands	India
India: Andhra Pradesh	India
India: Andhra Pradesh state	India
India: Andhra Pradesh, Nandyal	India
India: Andhra Pradesh, Srisailam	India
India: Andhra Prdesh state	India
India: Assam, Jorhat district	India
India: Atri	India
India: Baghmara Reserve Forest, Meghalaya	India
India: Balpakram National Park, Meghalaya	India
India: Bangalore, IISc	India
India: Bani, Kathua district of Jammu	India
India: Baramulla	India
India: Bay of Bengal	India
India: Benakoppa, Karnataka	India
India: Bengali fish market	India
India: Bijender Singh	India
India: Borabanda vegetable market	India
India: CSIR, Pappanamcode	India
India: Chamarajpet, Bangalore, Karnataka	India
India: Chamba District, Himachal Pradesh	India
India: Chambal Ravines, Baba devpur, Dist. Morena, Madhya Pradesh	India
India: Chamblyal	India
India: Chandigarh	India
India: Chetalli, Madikeri District, Karnataka State	India
India: Chikmangalur, Karnataka State	India
India: Churachandpur	India
India: Coimbatore	India
India: Coimbatore, Tamil Nadu	India
India: Coorg	India
India: Cuttack, Odisha	India
India: Deulajhari	India
India: Dhule, Maharastra State	India
India: Digha, West Bengal	India
India: Gangavati, Karnataka	India
India: Goa Coast, Dona Paula, Goa	India
India: Gujarat, Gandhinagar	India
India: Gujarat, Khambhat	India
India: Gujarat, Rajkot	India
India: Gujarat, Rann of Kutch	India
India: Gulbarga	India
India: Gulbarga District, Karnataka	India
India: Gulbarga University Gulbarga, Karnataka	India
India: Haldia in the East Midnapore district of West Bengal	India
India: Herbal Garden, Jamia Hamdard, New Delhi	India
India: Herur, Karnataka	India
India: Hooli, Karnataka	India
India: Imphal east	India
India: Jammu	India
India: Jammu, Shiwalik	India
India: Kakching	India
India: Kakinada, Andra Pradesh	India
India: Karnataka	India
India: Karnataka state	India
India: Karur	India
India: Kaziranga National Park, Assam	India
India: Keinou	India
India: Kolli Hill, Namakkal, Tamil Nadu	India
India: Koyambedu, Chennai	India
India: Kozhikode City, Kerala	India
India: Kozhikode, Kerala	India
India: Leh	India
India: Leh, Jammu and Kashmir	India
India: M.M. Hills, Chamarajanagar District, Karnataka State	India
India: Madurai, Tamil Nadu	India
India: Maharashtra	India
India: Maharashtra state	India
India: Mandovi estuaries, Goa	India
India: Mandya	India
India: Manikaran	India
India: Manipur	India
India: Marali, Karnataka	India
India: Meerut, Uttar Pradesh	India
India: Meghalaya	India
India: Monimala Mondal from Gangetic plain, Hooghly West Bengal	India
India: Muthupettai, Tamil Nadu	India
India: Mysore	India
India: Nandurbar, Maharashtra, Toranmal Forest	India
India: Nilliampathy	India
India: North Bay, Andaman island	India
India: North Bengal ,Saal Bagan	India
India: Odisha, Keonjhar	India
India: Patna, Bihar	India
India: Puliyettummal, Malappuram, Kerala	India
India: Puliyettummal, Malappuram, Kerala.	India
India: Pune	India
India: Punjab	India
India: Punjab, Jalandhar	India
India: Rajasthan state	India
India: Rajasthan, Jagatpura, Jaipur	India
India: Rajasthan, Jodhpur, Central Research Farm of Central Arid Zone Research Institute	India
India: Ranchi	India
India: Rannebenur, Karnataka State	India
India: Rohtak, Haryana	India
India: Rohtang Pass, Himachal Pradesh	India
India: Rowa Wildlife Sanctuary, Tripura	India
India: Saharanpur	India
India: Sallamangalam, Tamilnadu	India
India: Shivalik Region	India
India: Shiwalik	India
India: Solan	India
India: Sulthanbatheri, Kerala State	India
India: Talasari, Odisah	India
India: Talcauvery, Madikeri District, Karnataka	India
India: Tamil Nadu state	India
India: Tamil Nadu, Madurai, Pudukottai, Nagamalai	India
India: Tamil Nadu, northern part of Vellore city, Katpadi	India
India: Tamilnadu, Chennai	India
India: Tamilnadu, Virudhunagar	India
India: Tenali fields, Andra Pradesh	India
India: Thamlakkhuren village	India
India: Thanjavur	India
India: Thanjavur, Tamilnadu	India
India: Thondi, Palk Strait	India
India: Tiruchengode, Tamil Nadu	India
India: Tirupati	India
India: Tirupati, Andhra Pradesh	India
India: Tura Reserve Forest, Meghalaya	India
India: Tuticorin District, Tamilnadu	India
India: Uttara Khand	India
India: Vaddarhatti, Karnataka	India
India: Varangode, Malappuram, Kerala	India
India: Vellar Estuary, Parangipettai, Tamil Nadu	India
India: Vellore, Tamilnadu	India
India: Virdhunagar Dist.	India
India: Wabagai	India
India: Wayanad, Kerala State	India
India: West Bengal, Kolkata, Ghusighata	India
India: Western Ghats	India
India: Western Ghats, Agumbe, Karnataka	India
India: Western Ghats, South India	India
India: Wise Park Industrial Area, Kanjikode, Palakkad	India
India: coastal region of Orissa	India
India: near Erode, TN	India
India: northeastern Karnataka	India
India: oceanic soil, Pondicherry	India
India:Eastern Ladakh	India
India:Karnataka	India
India:Manipur, Impahal forest	India
India:Sagar, Madhya Pradesh	India
India:Solapur, Solapur	India
India:Varanasi district	India
Indian Ocean: Southwest Indian Ocean	Indian Ocean
Indonesia: Central Kalimantan,Palangkaraya	Indonesia
Indonesia: Java, Buitenzorg	Indonesia
Indonesia: Padang Halaban, North Sumatra	Indonesia
Indonesia: Parung, Bogor, West Java, elevation 110 m asl	Indonesia
Indonesia: West Java	Indonesia
Indonesia:South Sumatra	Indonesia
Indonesia:West Java	Indonesia
Iran: Kashmar	Iran
Iran: Mazandaran, Noshahr	Iran
Iran: Urmia Saline Lake	Iran
Ireland: Gurraig Sound, Galway	Ireland
Ireland: Phoenix Park, Dublin	Ireland
Italy: Apulia	Italy
Italy: Castel Gandolfo, Rome	Italy
Italy: Crypt, Capuchin friars in Rome	Italy
Italy: Florence	Italy
Italy: Latium	Italy
Italy: Lazio	Italy
Italy: Piedmont, Torino	Italy
Italy: Rome, British Institute's library	Italy
Italy: Rome, Corte Costituzionale's library	Italy
Italy: Rome, Pio Pontificio Latino-Americano's library	Italy
Italy: Rome, Vaticano's library	Italy
Italy: Sacco River, Latium	Italy
Italy: Sacco River, Latium region	Italy
Italy: Sicily, Marine Protected Area Isole Pelagie, Linosa (AG)	Italy
Italy: Tarquinia, Necropoli of Monterozzi	Italy
Italy: Trentino	Italy
Italy: Varese	Italy
Italy: Veneranda Biblioteca Ambrosiana, Milan	Italy
Italy: crypt of the Capuchin friars, Rome	Italy
Italy: the Crypt, Rome	Italy
Italy:Apulia	Italy
Italy:Apulia, Brindisi	Italy
Italy:Milan, Richini's courtyard of Ca'Granda	Italy
Italy:Puglia	Italy
Italy:Sardinia, Berchidda, OT	Italy
Japan: Chiba	Japan
Japan: Chiba, Chosei	Japan
Japan: Chiba, Matsudo, Faculty of horticulture, Chiba University	Japan
Japan: Hokkaido, Mt. Rishiri	Japan
Japan: Ibaraki, Tsukuba	Japan
Japan: Kyoto	Japan
Japan: Mie	Japan
Japan: Miyagi, Mt. Zao	Japan
Japan: Nehira	Japan
Japan: Okinawa, Okinawa island, Seragaki Beach	Japan
Japan: Okinawa, Okinawa-island, Seragaki beach	Japan
Japan: Suruga Bay, off Fujikawa	Japan
Japan: Tamba Prov.	Japan
Japan:Aomori, Hirosaki	Japan
Japan:Chiba, Chosei	Japan
Japan:Chiba,Chiba University hospital	Japan
Japan:Ehime, Iyo, Marutomo co., ltd	Japan
Japan:Fukushima, Mt. Higashi-Azuma	Japan
Japan:Hiroshima, Akitsu	Japan
Japan:Hokkaido, Kushiro	Japan
Japan:Iwate, Mt. Hachimantai	Japan
Japan:Iwate, Mt. Hayachine	Japan
Japan:Kyoto, Higashiyama-ku, Mt. Kohdaiji	Japan
Japan:Kyoto, Sakyo-ku, Oiwake-cho	Japan
Japan:Miyagi, Mt. Zao	Japan
Japan:Nara	Japan
Japan:Niigata, Mt. Myoko	Japan
Japan:Niigata, Mt. Naeba	Japan
Japan:Sagami Bay, off Hatsushima	Japan
Japan:Saitama-ken, Kasukabe-shi, Nishikananoi	Japan
Japan:Tsukuba	Japan
Japan:Yamanashi	Japan
Kazakhstan: Akmolinskyi region	Kazakhstan
Kazakhstan: Almaty Oblast	Kazakhstan
Lithuania: southwestern	Lithuania
Malaysia: Kedah	Malaysia
Malaysia: Kedah, Langkawi	Malaysia
Malaysia: Kuala Perlis	Malaysia
Malaysia: Pahang State, Gambang	Malaysia
Malaysia: Pahang State, Kuantan	Malaysia
Mexico: Colima	Mexico
Mexico: EjidoPaura in Mezquital, Durango	Mexico
Mexico: Morelos, Xochitepec	Mexico
Mexico: Sinaloa	Mexico
Mexico: Tabasco	Mexico
Mexico: Tulip	Mexico
Mexico: Zapotitlan-Puebla, Biosphere Reserve	Mexico
Nepal:Himalaya	Nepal
Netherlands: Utrecht	Netherlands
New Caledonia: Port Laguerre	New Caledonia
New Caledonia:Port Laguerre	New Caledonia
New Zealand: North Island	New Zealand
New Zealand: South Island	New Zealand
Nigeria: Ebutte-Meta, Lagos State	Nigeria
Nigeria: Okobaba Sawmill, Ebutte Meta, Lagos State	Nigeria
Nigeria: south western Nigeria, Oyo State, Ibadan, waste dumpsite at Awotan Apete	Nigeria
Oman: Muscat	Oman
Pacific Ocean: 4480m at site of WP02-3	Pacific Ocean
Pacific Ocean: Central	Pacific Ocean
Pacific Ocean: Eastern	Pacific Ocean
Pacific Ocean: Northeast Pacific Ocean	Pacific Ocean
Pacific Ocean: Sea of Okhotsk	Pacific Ocean
Pacific Ocean: central	Pacific Ocean
Pacific Ocean:East Pacific Ocean	Pacific Ocean
Pacific Ocean:West Pacific Ocean	Pacific Ocean
Pakistan: Abbotabad, North-West Frontier Province	Pakistan
Pakistan: Himalayan region, Nathia Gali	Pakistan
Pakistan: Islamabad, Quaid-i-Azam University	Pakistan
Pakistan: Tirich Mir glaciers Chitral, KP	Pakistan
Pakistan:Faisalabad	Pakistan
Pakistan:Punjab	Pakistan
Panama: Soberania National Park, Pipeline Road	Panama
Peru:Province Chachapoyas, City of Magdalena, 2000m a.s.l.	Peru
Peru:Province Chachapoyas, Granada village, 3000m a.s.l.	Peru
Philippines: La Trinidad, Benguet	Philippines
Portugal: Azores	Portugal
Portugal: Coimbra	Portugal
Puerto Rico: Antenna, Mona	Puerto Rico
Puerto Rico: Cayo Largo	Puerto Rico
Puerto Rico: Cayo Lobos	Puerto Rico
Puerto Rico: Cerezo, Mona	Puerto Rico
Puerto Rico: Culebra	Puerto Rico
Puerto Rico: Culebrita	Puerto Rico
Puerto Rico: Diablo	Puerto Rico
Puerto Rico: Fajardo	Puerto Rico
Puerto Rico: Guamani	Puerto Rico
Puerto Rico: Humacao	Puerto Rico
Puerto Rico: Icacos	Puerto Rico
Puerto Rico: Isla Pineros	Puerto Rico
Puerto Rico: Jobos	Puerto Rico
Puerto Rico: Luis Pena	Puerto Rico
Puerto Rico: Mona	Puerto Rico
Puerto Rico: Palomino	Puerto Rico
Puerto Rico: Vieques	Puerto Rico
Puerto Rico:Cabezas de San Juan	Puerto Rico
Romania: Ursilor Cave	Romania
Romania:Meziad Cave, National Park Apuseni Mountains	Romania
Romania:Movile cave	Romania
Romania:Nerja Cave, Andalusia	Romania
Romania:Ursilor cave	Romania
Romania:near Movile Cave, Mangalia, Dobrogea	Romania
Romania:near Moville Cave, Mangalia	Romania
Ross Sea	antarctica
Russia: 3 km west of Uthoss	Russia
Russia: Iturup Island	Russia
Russia: Kiev	Russia
Russia: Krasnodar Region, excavations in Phanagorii	Russia
Russia: Leningrad region	Russia
Russia: Moscow Region	Russia
Russia: Murmansk region	Russia
Russia: Shikotan Island	Russia
Russia: Voronezh Region	Russia
Russia:Astrachan	Russia
Russia:Black Sea	Russia
Russia:Kolymskaya lowland, Chukochaya river mouth	Russia
Russia:Moscow	Russia
Russia:Rostov-on-Don	Russia
Russia:Smolensk	Russia
Russia:St. Peterburg	Russia
Russia:Voronej region	Russia
Saudi Arabia: Abha, Asir	Saudi Arabia
Saudi Arabia: Madinah	Saudi Arabia
Saudi Arabia: Riyadh	Saudi Arabia
Saudi Arabia: villages located in Mecca regio	Saudi Arabia
Saudi Arabia:Al Qurayat	Saudi Arabia
Slovenia: Provost church, Ljubljana	Slovenia
Slovenia: Secovlje Saltern	Slovenia
Slovenia:Notranjska	Slovenia
South Africa: Deneysville, Vaal River	South Africa
South Africa: Potehefstroon	South Africa
South Africa: St. Helena Bay	South Africa
South Africa: Western Cape	South Africa
South Korea: Chungchugnam-do province	South Korea
South Korea: Dadaepo Beach	South Korea
South Korea: Daegu City, Duribong tunnel	South Korea
South Korea: Jeju	South Korea
South Korea: Jeju Island	South Korea
South Korea: Jeju island	South Korea
South Korea: Miryang, National Institute of Crop Science	South Korea
South Korea: Namhae	South Korea
South Korea: Seoul, Bukhan Mountain	South Korea
South Korea: South Coast, Namhae	South Korea
South Korea: Wan Island	South Korea
South Korea: Yeoju	South Korea
South Korea:Yellow Sea	South Korea
Spain: Albacete	Spain
Spain: Alicante	Spain
Spain: Canary Islands	Spain
Spain: Castilla La Mancha region	Spain
Spain: Ciudad Real, Membrilla	Spain
Spain: Covalanas and La Haza (Cantabria)	Spain
Spain: Guadalajara, Tortuero	Spain
Spain: Mediterranean Sea	Spain
Spain: Tinajo, Lanzarote, Canary Islands	Spain
Spain: Valladolid	Spain
Spain:Altamira Cave	Spain
Spain:Andalusia, Nerja Cave	Spain
Spain:Barcelona	Spain
Spain:Caceres, Castanar de Ibor Cave	Spain
Spain:Castanar Ibor cave	Spain
Spain:Castanar de Ibor Cave (Caceres)	Spain
Spain:Extremadura	Spain
Spain:Jaen	Spain
Spain:Malaga	Spain
Spain:Nerja Cave, Andalusia	Spain
Spain:Salamanca	Spain
Spain:Tarragona	Spain
Spain:near Cueva de Dona Trinidad, Ardales, Andalucia	Spain
Sri Lanka: Kerudavil	Sri Lanka
Sri Lanka:Kandi District	Sri Lanka
Sri Lanka:Kandy District, Kandy	Sri Lanka
Sudan: Khartoum, Khartoum University Botany Department	Sudan
Sweden: Bispgaarden	Sweden
Switzerland:Hofstetten near Basle, Swiss Canopy Crane	Switzerland
Syria: southern region	Syria
Taiwan: I-lan, Fu-shan	Taiwan
Taiwan:Taichung city	Taiwan
Thailand: Andaman Sea and Gulf of Thailand	Thailand
Thailand: Chiang Mai	Thailand
Thailand: Khon Kaen Province	Thailand
Thailand: Rajjaprabha Dam, Surat, Thani	Thailand
Thailand: Teak forest	Thailand
Thailand: natural forest located at the Queen Sirikit Botanic Garden, Mae-Rim district, Chiang Mai	Thailand
Thailand: southern Thailand, Gulf of Thailand and Andaman Sea	Thailand
Trinidad and Tobago:Tunapuna	Trinidad and Tobago
Tunisia: Sebkha El-Melah	Tunisia
Turkey: Balya, Balikesir	Turkey
Turkey: Can, Canakkale	Turkey
Turkey: Istanbul	Turkey
Turkey: Izmir, Bornova	Turkey
USA: 16 km north of Rawlins, Wyoming	United States
USA: 20 km east of Little America, Wyoming	United States
USA: 8 km east of Portal, Arizona	United States
USA: Alabama	United States
USA: Antler Ridge Property, Missoula, MT	United States
USA: Bartlett Experimental Forest, Bartlett, NH	United States
USA: Bastrop, Texas	United States
USA: Bull Creek Park, Texas	United States
USA: CT	United States
USA: Carlsbad, New Mexico	United States
USA: City of Durham Compost Facility, NC	United States
USA: Connecticut	United States
USA: District of Columbia	United States
USA: Hawaii	United States
USA: Hawaii, Kuaunai	United States
USA: Hilo, HI	United States
USA: Hornsby Bend Environmental Research Center, Texas	United States
USA: Idaho, Minidoka Co.	United States
USA: Indiana	United States
USA: Kartchner Caverns, Benson, Arizona	United States
USA: Kuli'ou'ou Beach Park in Hawaii Kai, Oahu, Hawaii	United States
USA: MS, Hinds County	United States
USA: MS, Leake County	United States
USA: MS, Madison County	United States
USA: Nebraska	United States
USA: New Jersey	United States
USA: New Mexico	United States
USA: New Orleans, Lakeview area	United States
USA: Oahu, Hawaii	United States
USA: Ogden, Utah	United States
USA: Okefenokee National Wildlife Refuge, Ware County, Georgia	United States
USA: Oklahoma, Great Salt Plains	United States
USA: Oklahoma, near Buffalo Valley, Cedar Creek	United States
USA: Orange Co., NC	United States
USA: Peoria, Illinois	United States
USA: Pine Flat, Tulane County, California	United States
USA: Puerto Rico, Cabo Rojo	United States
USA: Socorro County, Seviletta Natl. Wildlife Refuge, New Mexico	United States
USA: South Carolina	United States
USA: South Florida, Crab Cove	United States
USA: Starr Valley, Wyoming	United States
USA: Stengl Biology Station, Texas	United States
USA: Storrs, Connecticut	United States
USA: TN, GRSM, Copeland Creek	United States
USA: TN, GSMNP Bullhead Tr	United States
USA: Table rock road/highway 80, Wyoming	United States
USA: Tennessee, Oak Ridge	United States
USA: University of Iowa, Department of Pathology	United States
USA: Waikiki, Hawaii	United States
USA: Walnut Crater, Arizona	United States
USA: Wyoming	United States
USA: coconut island, Oahu, Hawaii	United States
USA:Alabama	United States
USA:Arizona, Benson, Kartchner Caverns	United States
USA:Florida	United States
USA:Glenrock, Wyoming	United States
USA:Hawaii	United States
USA:Hawaii, Alien Wet Forest	United States
USA:Idaho, Boise	United States
USA:Kentucky	United States
USA:Missouri	United States
USA:New Jersey	United States
USA:Oregon	United States
USA:Shemja Island	United States
USA:Virginia	United States
USA:Waycross, Georgia	United States
USA:Wyoming	United States
Ukraine: Kharkov	Ukraine
Ukraine: The Crimea	Ukraine
United Kingdom: Drigg Coast	United Kingdom
United Kingdom: Glasgow, Scotland	United Kingdom
United Kingdom: Kirkudbright DU gardens	United Kingdom
United Kingdom: Nab farm, Nr Kepwick, Yorkshire	United Kingdom
United Kingdom: Scotland, Angus, University of Dundee	United Kingdom
United Kingdom: Somerset	United Kingdom
United Kingdom: Surrey, Kew	United Kingdom
Viet Nam: Danang	Vietnam
Viet Nam: Nghe An	Vietnam
Viet Nam:Bien hoa	Vietnam
Viet Nam:Binh My	Vietnam
Viet Nam:Cau Dien	Vietnam
Viet Nam:Hanoi	Vietnam
Viet Nam:Khanh Hoa	Vietnam
Viet Nam:Phu hua	Vietnam
Viet Nam:Quang Tri	Vietnam
Viet Nam:Tam Hiep	Vietnam
Viet Nam:Van Noi	Vietnam
Zaire	Democratic Republic of the Congo
Zaire: Leopodville, Nsang-Ngidinga River	Democratic Republic of the Congo
Zambia: Peoria	Zambia
Pacific Ocean	Pacific Ocean
