# version-2
period	month6	Month 6	1
period	month12	Month 12	2
period	month18	Month 18	3
body_habitat	Colon	Colon
body_product	UBERON:feces	Feces
body_site	colon	Colon
laz 1 month after sampling	NA	:::UNDEF:::
laz 3 months after sampling	NA	:::UNDEF:::
stunted 3 months after sampling	NA	:::UNDEF:::
days since last diarrheal episode	NA	:::UNDEF:::
mean duration of campylobacter-negative diarrheal episodes in days	NA	:::UNDEF:::
mean duration of campylobacter-positive diarrheal episodes in days	NA	:::UNDEF:::
mean duration of diarrheal episodes in days	NA	:::UNDEF:::
mean severity of campylobacter-negative diarrheal episodes	NA	:::UNDEF:::
mean severity of campylobacter-positive diarrheal episodes	NA	:::UNDEF:::
mean severity of diarrheal episodes	NA	:::UNDEF:::
number of campylobacter-negative diarrheal episodes	NA	:::UNDEF:::
number of campylobacter-positive diarrheal episodes	NA	:::UNDEF:::
percentage of diarrheal samples positive for campylobacter	NA	:::UNDEF:::
percentage of surveillance stools positive for campylobacter	NA	:::UNDEF:::
